Cordelia Hotel is situated in Tbilisi, a 3-minute walk away from Saint Trinity Church.	Отель Cordelia расположен в Тбилиси, в 3 минутах ходьбы от Свято-Троицкого собора.
At Tupirmarka Lodge you will find a 24-hour front desk, room service, and a snack bar.	В числе удобств лоджа Tupirmarka круглосуточная стойка регистрации и снэк-бар. Гости могут воспользоваться услугой доставки еды и напитков в номер.
Featuring free WiFi in all areas, Naigao Xiaowo offers accommodation in Shanghai.	Апартаменты Naigao Xiaowo расположены в городе Шанхай. К услугам гостей бесплатный Wi-Fi во всех зонах.
Each has a TV and a private bathroom with shower.	В вашем распоряжении также телевизор и собственная ванная комната с душем.
Your room comes with air conditioning and satellite TV.	Номер оснащен кондиционером и спутниковым телевидением.
They are styled in cream-coloured hues and some of them feature private balconies with seating areas.	Они оформлены в кремовых тонах, в некоторых из них имеются отдельные балконы с гостиной зоной.
The reception team can help guests plan sightseeing trips.	Сотрудники стойки регистрации с радостью помогут гостям спланировать экскурсии.
Some units include a seating area for your convenience.	В числе удобств некоторых номеров — гостиная зона.
Nieuwmarkt as well as Kalverstraat, Hermitage and Rembrandtplein are within 15 minutes walking.	До площади Ниумаркт, торговой улицы Калверштрат, музея Эрмитаж на Амстеле и площади Рембрандта можно дойти менее чем за 15 минут.
The Danube Delta is a natural reserve where you can go fishing, bird watching, take boat rides or simply unwind surrounded by nature.	Дельта Дуная является природным заповедником, в котором можно заняться рыбной ловлей, понаблюдать за птицами, покататься на лодке или просто расслабиться в окружении природы.
The air-conditioned rooms offer a flat-screen TV with cable channels, a desk, fan and seating area.	Номера оснащены кондиционером, телевизором с плоским экраном и кабельными каналами, письменным столом, вентилятором и гостиной зоной.
Each apartment is fitted with a balcony, flat-screen cable TV and safety deposit box.	Каждые апартаменты располагают балконом, сейфом и телевизором с плоским экраном и кабельными каналами.
Located 500 metres from Church of the Savior on Spilled Blood in Saint Petersburg, this apartment features free WiFi. The apartment is 700 metres from Palace Square.	Эти апартаменты с бесплатным Wi-Fi расположены в Санкт-Петербурге, в 500 метрах от храма Спаса-на-Крови и в 700 метрах от Дворцовой площади.
The kitchen includes a dishwasher and oven.	На кухне установлены посудомоечная машина и духовой шкаф.
An array of activities can be enjoyed on site or in the surroundings, including skiing, cycling and horse riding.	Территория и окрестности отлично подходят для активного отдыха, в том числе лыжного спорта, велосипедных прогулок и верховой езды.
Free WiFi is accessible throughout the premises.	На всей территории работает бесплатный Wi-Fi.
They include flat-screen satellite TV, a safe and en-suite bathroom with hairdryer.	В них также имеются такие удобства, как телевизор с плоским экраном и спутниковыми каналами, сейф и ванная комната с феном.
Free WiFi access is available in all areas.	На всей территории работает бесплатный Wi-Fi.
Valledoria is a 17-minute drive from the property, and Porto Torres is 34 km away.	Отель находится в 17 минутах езды от городка Валледории и в 34 км от города Порто-Торреса.
Towels and bed linen are provided in this self-catering accommodation.	Предоставляются полотенца и постельное белье.
The spa offers massages with a view of the sea, a fitness room and aqua gym.	В спа-центре предлагается массаж с видом на море, а также можно посетить фитнес-зал и аквааэробику.
Paignton Bus and Rail Station is only 5 minutes away on foot, and Paignton Pier can be reached in less than a 5-minute walk.	Гостевой дом находится всего в 5 минутах ходьбы от автобусного и железнодорожного вокзалов Пейнтона и менее чем в 5 минутах ходьбы от пристани Пейнтона.
A flat-screen TV is offered.	В числе прочих удобств -— телевизор с плоским экраном.
Organic, locally sourced ingredients are blended in the Mediterranean dishes of its stylish restaurant.	В стильном ресторане отеля подают блюда средиземноморской кухни из органических местных продуктов.
Each room at Sport Hotel comes with a TV with cable channels and a private bathroom with a shower.	Каждый номер в отеле Sport оснащен телевизором с кабельными каналами. В собственной ванной комнате можно принять душ.
Featuring a well-maintained garden, Emerald Residency offers luggage storage and car rental facilities. A tour desk and business centre are also present.	Помимо прочего, разбит ухоженный сад. В гостевом доме Emerald Residency имеется место хранения багажа и работает прокат автомобилей, экскурсионное бюро и бизнес-центр.
Guests can unwind in indoor and outdoor hot spring baths.	Гости могут посетить купальни с водой из горячих источников в помещении и на открытом воздухе.
The apartment features chic décor, high ceilings and a balcony with sea views.	В этих апартаментах с высоким потолком и роскошным декором есть балкон с видом на море.
You can engage in various activities, such as horse riding, windsurfing and cycling.	В окрестностях есть все условия для активного отдыха, включая виндсерфинг, верховую езду и велосипедные прогулки.
Breakfast is served in the garden, in the rooms or in the dining area.	Завтрак сервируют в саду, в номерах или в обеденной зоне.
A dishwasher is also available.	Также установлена посудомоечная машина.
Macedonia International Airport is 130 km away.	Расстояние до международного аэропорта «Македония» составляет 130 км.
All units also include a private bathroom with shower equipped with a hairdryer.	Все номера располагают собственной ванной комнатой с душем и феном.
Guest House Jam features free WiFi throughout the property.	На всей территории гостевого дома Jam работает бесплатный Wi-Fi.
Free private parking is available on site.	На территории обустроена бесплатная частная парковка.
There is also a terrace.	Кроме того, обустроена терраса.
Located on the 4th floor with no lift, this apartment features a kitchenette is fitted with a dishwasher and a microwave, as well as a coffee machine and a kettle.	Апартаменты находятся на 5 этаже здания без лифта. В числе удобств мини-кухня с посудомоечной машиной, микроволновой печью, кофемашиной и чайником.
The beach in Canneto is 15 minutes' drive away.	Поездка до пляжа Каннето занимает 15 минут.
Other facilities offered include a shared lounge and a games room.	Гости могут посетить общий лаундж и игровую комнату.
There is also a floral garden and a children’s playground.	Возле отеля разбит сад с цветниками, и обустроена детская игровая площадка.
Apartments at La Ferula come with a flat-screen TV, kitchen and dining area.	Апартаменты комплекса La Ferula располагают телевизором с плоским экраном, кухней и обеденной зоной.
A selection of restaurants and bars are located in the surrounding streets.	На близлежащих улицах открыто множество разнообразных ресторанов и баров.
Apache Gold Casino is 5 minutes’ drive from the hotel.	Поездка до казино Apache Gold занимает 5 минут.
Staff can arrange boat trips around the Gulf of Trieste.	Персонал может организовать экскурсии на корабле вокруг залива Триеста.
Located opposite the Hartford-Brainard Airport, this Days Inn Hartford is 6 minutes’ drive from the Connecticut Convention Center and Trinity College is 3 miles away.	Отель Days Inn Hartford находится напротив аэропорта Хартфорд-Брейнард, в 6 минутах езды от конгресс-центра Коннектикута и в 4,8 км от Тринити-колледжа.
Rooms include a private bathroom equipped with shower and free toiletries.	К услугам гостей собственная ванная комната с душем и бесплатными туалетно-косметическими принадлежностями.
Pueblo Antiguo and Café Britt coffee plantation are a 10-minute drive from the hotel, and the Poas Volcano is a 40-minute drive away.	Отель Country Inns & Suites by Carlson расположен в 40 минутах езды от вулкана Поас и в 10 минутах езды от парка Пуэбло Антигуо и кофейной плантации Кафе-Бритт.
At a surcharge guests can have breakfast at Meriton Old Town Garden Cafe which is located next door.	За отдельную плату для гостей сервируют завтрак в соседнем кафе Meriton Old Town Garden.
Simferopol Airport is 70 km away.	Расстояние до аэропорта Симферополь составляет 70 км.
Breakfast is served daily in a café just 20 metres from the hotel.	Завтрак подается каждый день в кафе всего в 20 метрах от отеля.
Mobile homes are modern and come with a bathroom with shower.	В современных передвижных домах также имеется ванная комната с душем.
At Riverside Garden Villas, you will find a hot tub, a 24-hour front desk and a peaceful garden.	В комплексе вилл Riverside Garden в распоряжении гостей гидромассажная ванна, круглосуточная стойка регистрации и тихий сад.
Restaurants and a supermarket are 1 km away.	В 1 км от апартаментов работают рестораны и супермаркет.
The island’ port is accessible within a short drive and Naxos National Airport is approximately 3 km away.	Поездка от гостевого дома до порта острова займет несколько минут, а Национальный аэропорт Наксоса находится примерно в 3 км.
Appartement CA200 in Cannes is located just 500 metres from the beach and features a terrace and garden.	Апартаменты CA200 расположены в Каннах, всего в 500 метрах от пляжа. К услугам гостей терраса и сад.
With a Moroccan-style décor, all the air-conditioned rooms at Riad Rime offer a TV and a wardrobe. A private bathroom with a shower is also provided.	В распоряжении гостей каждого оформленного в марокканском стиле номера риада Rime — кондиционер, телевизор, шкаф для одежды и собственная ванная комната с душем.
Ski Lodge is a holiday home located in the centre of Brides-les-Bains, a 2-minute walk from Olympe Gondola.	Дом для отпуска Ski Lodge находится в центре горнолыжного курорта Брид-ле-Бен, в 2 минутах ходьбы от гондольного подъемника Олимп.
This hotel is located in Herrieden.	Отель Genießerhotel Limbacher находится в городе Херриден.
Free on-site parking is available for cars, trucks, and buses at Bay City Regency Inn.	На территории мотеля Bay City Regency оборудована бесплатная парковка для автомобилей, грузовиков и автобусов.
Slippers are provided and most rooms have great mountain views.	Гостям предоставляются тапочки. Из большинства номеров открывается великолепный вид на горы.
Palace Jasmine is 15 km from Trivandrum International Airport.	Отель Palace Jasmine находится в 15 км от международного аэропорта Тривандрума.
Area activities include hiking and day trips along the Golden Circle.	Гости могут отправиться в пешие походы и однодневные поездки по Золотому кольцу Исландии.
The property offers free parking.	Также обустроена бесплатная парковка.
An array of activities can be enjoyed on site or in the surroundings, including cycling, hiking and canoeing.	На территории комплекса Miejsce Fajne и за его пределами гости могут заняться велосипедными и пешими прогулками, а также греблей на каноэ.
A daily breakfast is offered which guests can enjoy in the bright breakfast area, also with lake views.	Завтрак подается ежедневно в светлом зале для завтраков с видом на озеро.
Being in the centre of Ciampino you are surrounded by cafés and restaurants.	Отель расположен в центре Чампино, где работает множество кафе и ресторанов.
The kitchen is equipped with a dishwasher.	Кухня оснащена посудомоечной машиной.
Only 100 metres from the shores of the Black Sea, this cosy pension offers air-conditioned rooms and free Wi-Fi.	Уютный мотель Side расположен всего в 100 м от берега Черного моря. К услугам гостей номера с кондиционером и бесплатным Wi-Fi.
Located in the town of Tinos, Athos Studios is only 50 metres from Kalamia Beach and features a bar.	Отель Athos Studios с собственным баром расположен в городе Тинос, всего в 50 метрах от пляжа Каламия.
Enjoying a waterfront position just 100 metres from the pebbly beach, Hotel Soan is 3 km from the centre of Sarandë.	Отель Soan находится на побережье, всего в 100 метрах от галечного пляжа и в 3 км от центра города Саранда.
All units come with a furnished balcony or terrace.	Все номера комплекса оборудованы меблированным балконом или террасой.
An array of activities can be enjoyed on site or in the surroundings, including hiking.	На территории дома для отпуска или в его окрестностях можно заняться различными видами активного отдыха, в том числе пешим туризмом.
An array of activities can be enjoyed on site or in the surroundings, including table tennis.	Рядом с домом для отпуска и в окружающем регионе можно заняться различными видами активного отдыха, в том числе поиграть в настольный теннис.
Just a short walk away, guests can also find a super market, where they can buy their daily necessities.	Всего в нескольких минутах ходьбы также работает супермаркет, где продаются товары повседневного спроса.
An array of activities can be enjoyed on site or in the surroundings, including skiing, cycling and hiking.	В окрестностях лоджа созданы отличные условия для пеших походов, катания на велосипеде, лыжного спорта и других видов активного отдыха.
The property is situated at the foot of the Mystic Mirnock Mountain which has numerous cycling and hiking routes.	Апарт-отель расположен у подножия горы Мистик Мирнок, на которой проложены многочисленные велосипедные и пешеходные дорожки.
Entertainment is provided on most week nights.	Почти каждый вечер в отеле проводятся развлекательные мероприятия.
Cunda's centrum is 1.5 km, and Ayvalik city centre is 2 km from the property.	Центр Кунды находится в 1,5 км от гостевого дома, а центр города Айвалык - в 2 км.
There is a 24-hour front desk at the property.	Стойка регистрации работает круглосуточно.
Opéra Garnier is 2.6 km from Petit Trianon-Etoile, while Orsay Museum is 2.7 km from the property.	Апартаменты расположены в 2,6 км от театра Гранд-опера и в 2,7 км от музея Орсе.
Alicante Airport can be reached by car in 1 hour.	Поездка до аэропорта Аликанте займет 1 час.
Located in the Copacabana district of Rio de Janeiro, the Hotel Biarritz invites you to rest in accommodations equipped with king-size beds and air conditioning.	Отель Biarritz расположен в районе Копакабана в Рио-де-Жанейро. Приглашаем вас отдохнуть в номерах, оборудованных кроватями "king-size" и кондиционером.
This Islamic hotel offers separate outdoor pools for men and women, and a terrace overlooking the sea.	Этот мусульманский отель располагает отдельными открытыми бассейнами для мужчин и женщин, а также террасой с видом на море.
ACC Liverpool is 3.2 km from Sefton Grange , while Liverpool Echo Arena is 3.2 km from the property.	Выставочный и конференц-центр ACC Liverpool, а также спортивно-развлекательный комплекс Echo Arena расположены в 3,2 км от гостевого дома Sefton Grange.
Private parking is available on site.	Гостям предоставляется частная парковка на территории.
This country house is 70 km from Federico Garcia Lorca Granada-Jaen Airport.	Этот загородный дом находится в 70 км от аэропорта им. Федерико Гарсиа Лорки Гранада-Хаэн.
Some rooms are fitted with traditional futon bedding, while others have Western beds.	В некоторых номерах уложены традиционные матрасы футоны, а в других установлены кровати в западном стиле.
The Sport Vital Hotel’s sports programme includes guided hiking and mountain bike tours, aqua gymnastics, and activities such as yoga and pilates.	Спортивная программа спорт-отеля Vital включает организованные походы и туры на горных велосипедах, аквааэробику, а также занятия йогой и пилатесом.
All guests can enjoy panoramic mountain views from their south-west facing balcony.	Балкон в апартаментах выходит на юго-запад. С балкона открывается панорамный вид на горы.
It features a luxury spa centre and rooms with an LCD TV and free WiFi access.	К услугам гостей номера, оснащенные ЖК-телевизором и бесплатным Wi-Fi, а также роскошный спа-центр.
There is a spacious lounge to spend time with friends and a small Library Lounge where guests can read a good book and have a cup of coffee or tea.	Гости могут провести время с друзьями в просторном лаундже или почитать книгу и выпить чашечку кофе или чая в небольшом лаундже с библиотекой.
A Continental breakfast buffet with fresh breads, pastries, fruits, cereals and sliced cold meats is offered for GBP 9.50.	По утрам для гостей сервируется континентальный завтрак «шведский стол», состоящий из булочек, выпечки, фруктов, мюслей и мясного ассорти. Стоимость завтрака составляет 9,5 фунтов стерлингов.
Apartments Hollaj is set in a peaceful part of Ulcinj, only 200 metres from Small Beach and pine forest.	Апартаменты Hollaj расположены в тихой части города Улцинь, всего в 200 метрах от пляжа Смол-Бич и соснового леса.
Guests have access to free WiFi in all areas and free public parking is available on site.	Во всех зонах действует бесплатный Wi-Fi. На территории обустроена бесплатная общественная парковка.
Bed linen and towels are provided.	Гостям предоставляются полотенца и постельное белье.
All apartments have a private furnished balcony and a kitchen with dining area.	Во всех апартаментах в вашем распоряжении собственный меблированный балкон и кухня с обеденной зоной.
All rooms offer splendid garden views.	Из каждого номера открывается великолепный вид на сад.
Located 200 metres from Caicó's AABB, Pousada Bom Gosto offers free Wi-Fi in public areas, 24-hour front desk service and a restaurant.	Гостевой дом Pousada Bom Gosto находится в 200 метрах от спортивно-развлекательного комплекса AABB в городе Кайко. К услугам гостей бесплатный Wi-Fi в местах общего пользования, круглосуточная стойка регистрации и ресторан.
Each room at this inn is air-conditioned and has a flat-screen cable TV and a kettle.	В числе удобств номеров кондиционер, телевизор с плоским экраном и кабельными каналами, а также чайник.
The accommodation features a large garden and a shared lounge with TV.	К услугам гостей большой сад и общий лаундж с телевизором.
Each offers a spacious living room with a flat-screen TV, while the kitchen includes an oven, a stove and a fridge.	Все они располагают просторной гостиной с телевизором с плоским экраном, а также кухней с духовкой, плитой и холодильником.
All rooms at The Denman include central heating, cable TV and a DVD player.	Во всех номерах отеля Denman в распоряжении гостей центральное отопление, кабельное телевидение и DVD-плеер.
At Pichepehuen guests will find barbecue and laundry facilities.	Гости дома для отпуска Pichepehuen могут воспользоваться стиральной машиной и принадлежностями для барбекю.
Simonovskiy Val Apartment offers accommodation in Moscow. The apartment is 3.8 km from Gorky Park.	Апартаменты «Симоновский вал» расположены в Москве, в 3,8 км от парка имени Горького.
The rooms are built out of natural materials like brick, wood and bamboo.	Номера построены с применением натуральных материалов, включая кирпич, дерево и бамбук.
There is also a kitchen, equipped with an oven. A refrigerator and stovetop are also offered, as well as a kettle.	Кухня укомплектована духовкой, холодильником, плитой и чайником.
At Aix Suite Location you will find a garden and a terrace.	На территории здания апартаментов Aix Suite Location разбит сад и обустроена терраса.
From the property, the popular Tower Bridge and Tower of London are 2.3 miles away and Cambridge Heath Train Station is a 5-minute walk to the north.	Расстояние до популярного Тауэрского моста и Тауэра составляет 3,7 км, а до железнодорожного вокзала Кембридж-Хит следует пройти в северном направлении всего 5 минут.
It consists of sweet food including croissants and cappuccino.	Он состоит из сладких блюд и включает круассаны с капучино.
The restaurant serves multi cuisine dishes, including Indian, Chinese and western choices.	В ресторане подаются блюда интернациональной кухни, в том числе блюда индийской, китайской и западной кухонь.
The property is situated in a convenient location close to attractions such as Blue Mosque and Hagia Sophia.	Дом находится в удобном месте, рядом с такими достопримечательностями, как Голубая мечеть и собор Святой Софии.
Local restaurants and supermarkets can be reached on foot in 5 minutes. Trogir city centre and the marina are a 15-minute walk away.	Местные рестораны и супермаркеты расположены в 5 минутах ходьбы от апартаментов. До центра города Трогир и порта можно дойти за 15 минут.
This family-run hotel is located 3 km from Leipzig Central Train Station and 5 minutes’ drive from Leipzig city centre.	Этот семейный гостевой дом находится в 3 км от центрального железнодорожного вокзала Лейпцига, в 5 минутах езды от центра города Лейпцига.
Chinatown is 13 minutes’ walk away.	Прогулка до Китайского квартала занимает 13 минут.
Located near national highways, the guesthouse is a 17-minute drive to Águeda, a 22-minute drive to Aveiro and a 40-minute drive to Coimbra.	Гостевой дом находится рядом с национальными автомагистралями, в 17 минутах езды от города Агеда, в 22 минутах от города Авейру и в 40 минутах езды от первой столицы Португалии - города Коимбры.
Each room comes with satellite TV, a minibar and a bathroom with a hairdryer and a shower or a tub.	Все номера располагают телевизором со спутниковыми каналами, мини-баром и ванной комнатой с феном и душем или ванной.
This medieval-themed hostal offers personalised rooms a shared lounge with a fireplace and flat-screen TV.	Гостевой дом оформлен в средневековом стиле. В нем есть индивидуально декорированные номера с общей гостиной, камином и телевизором с плоским экраном.
The nearest airport is Ben Gurion Airport, 19 km from the property.	До аэропорта имени Бен-Гуриона — 19 км.
The Sklep 57 has a garden, children’s playground, a bike storage room and free on-site parking for up to 4 cars.	Кроме того, в числе удобств дома для отпуска Sklep 57 сад, детская игровая площадка, помещение для хранения велосипедов и бесплатная парковка вместимостью до 4 автомобилей.
Pianeta Oro Avamposto Meteo also includes a sun terrace.	К услугам гостей комплекса Pianeta Oro Avamposto Meteo терраса для загара.
A fitness centre and swimming pool are available and free of charge.	Фитнес-центр и бассейн можно посещать бесплатно.
Ben Siesta provides excellent facilities and affordable luxury in serene surroundings, plus the comfort of home.	Прекрасно оснащенные апартаменты Ben Siesta - это сочетание доступной роскоши, спокойной атмосферы и домашнего уюта.
All apartments at Lapland Hotel Ounasvaara Chalets feature a private terrace and a living room with satellite TV.	Во всех апартаментах Lapland Ounasvaara Chalets имеется собственная терраса и гостиная со спутниковым телевидением.
Le Clos du Père Finet B&B is just over a 10-minute drive from Redu.	От гостевого дома типа «постель и завтрак» Le Clos du Père Finet - чуть более 10 минут езды до деревни Редю.
Offering light, elegant rooms and a 2 AA Rosette restaurant, Yeovil Court is less than 10 minutes’ drive from Yeovil’s centre.	В отеле к услугам гостей светлые, элегантные номера и 2 ресторана, удостоенных розочки ресторанного гида Автомобильной Ассоциации Великобритании. Отель Yeovil Court находится менее чем в 10 минутах езды от центра Йеавила.
A 1-minute walk from Shiomi Train Station, APA Hotel Tokyo Shiomi Ekimae offers western-style rooms with free wired internet and WiFi access.	В отеле APA Tokyo Shiomi Ekimae, расположенном в 1 минуте ходьбы от железнодорожного вокзала Сиоми, к услугам гостей номера в западном стиле с бесплатным проводным доступом в Интернет и Wi-Fi.
German beers and wines can be enjoyed on the terrace or in the conservatory.	На террасе или в зимнем саду можно приятно провести время за кружкой немецкого пива или бокалом вина.
Set within an impressive turreted granite building in the exclusive West End of Aberdeen, these fully-serviced luxury suites have been awarded 4 Diamonds from the RAC.	Отель расположен в величественном гранитном здании с башенкой в фешенебельном районе на западе Абердина. Он удостоен 4 "алмазов" по рейтингу RAC. К услугам гостей роскошные люксы с полным обслуживанием.
All units share bathroom facilities.	Все номера располагают общими ванными комнатами.
The bathroom includes bath, shower, bidet and a hairdryer.	В ванной комнате есть ванна, душ, биде и фен.
Horse riding is available on site and free parking is also provided.	На территории фермы желающие могут заняться конным спортом. Предусмотрена бесплатная парковка.
The Sanctuary Lounge offers refreshing cocktails and various dishes in a buffet or à la carte style.	В лаундже Sanctuary подают освежающие коктейли и разнообразные блюда в формате "шведского стола" или по меню.
Kings Lynn Golf Club is 1.5 miles away and historical Castle Rising can be reached in 5 minutes’ drive.	До гольф-клуба Кингс Линн 2,5 км, а до исторического замка Рост можно доехать за 5 минут.
With a rustic feel and wood beamed ceilings, every apartment features a seating area and dining table.	В числе удобств апартаментов в деревенском стиле с балочным потолком гостиный уголок и обеденный стол.
Traditional cuisine can be sampled in La Quietat’s on-site restaurant.	В ресторане на территории отеля La Quietat подают блюда традиционной кухни.
The spacious restaurant serves Hungarian cuisine.	В просторном ресторане подают блюда венгерской кухни.
Lake Geneva and Nyon are both an 8-minute drive away.	Поездка до Женевского озера и Ньона занимает 8 минут.
Talamanca Beach is 150 metres away.	Пляж Таламанка находится в 150 метрах.
Located in the centre of town, Warrego Hotel Motel Cunnamulla features a restaurant and air-conditioned rooms with a flat-screen TV.	Отель и мотель Warrego Cunnamulla находится в центре города. К услугам гостей ресторан и номера с кондиционером и телевизором с плоским экраном.
Towels are featured.	Гостям предоставляются полотенца.
A continental breakfast is served every morning.	Каждое утро гостям сервируют континентальный завтрак.
All units open to a balcony with unobstructed sea views.	Во всех апартаментах имеется балкон, откуда открывается прекрасный вид на море.
Free Parking is also available.	Гостям, путешествующим на автомобиле, предоставляется бесплатная парковка.
The gym’s fitness instructors can advise and help guests reach their goals.	Фитнес-инструкторы в тренажерном зале всегда готовы помочь гостям подобрать правильную нагрузку.
Located in Moraira, just 600 metres form Cala del Portitxolet Beach, Villa Oceano holiday home offers a beautiful garden, a covered terrace with barbecue facilities and an outdoor pool.	Дом для отпуска Villa Oceano находится в городе Морайра, всего в 600 метрах от пляжа Кала-дель-Портитксолет. К вашим услугам красивый сад, крытая терраса с принадлежностями для барбекю и открытый бассейн.
Offering an outdoor pool, barbecue and sun terrace, Pera Villalari is set in Kemer in the Mediterranean Region Turkey Region.	Вилла Pera Villalari с открытым бассейном и террасой для загара находится в курортном городе Кемер Средиземноморского региона Турции. Гости могут воспользоваться принадлежностями для барбекю.
There is also a kitchen, fitted with an oven and fridge.	В числе удобств кухня с духовкой и холодильником.
A seating area and private bathroom with shower and hairdryer are included.	В числе удобств гостиная зона и собственная ванная комната с душем и феном.
The nearest airport is Tbilisi International Airport, 11 km from Lilika Apartment at Shoropani.	Расстояние от апартаментов «Лилика на ул. Шорапани» до международного аэропорта Тбилиси составляет 11 км.
Toulon is 47 km from Villa Valdor.	Тулон находится в 47 км от виллы Valdor.
Some rooms are complete with a spa bath.	В некоторых номерах имеется гидромассажная ванна.
Free Wi-Fi access is provided.	Предоставляется бесплатный Wi-Fi.
A bicycle can be rented at an additional cost.	За дополнительную плату можно воспользоваться прокатом велосипедов.
Lek House comfortable rooms with a cable TV.	Постояльцам гостевого дома Lek House предлагается проживание в комфортабельных номерах с кабельным телевидением.
The rooms come with a TV and a private bathroom.	В номерах в распоряжении гостей телевизор и собственная ванная комната.
The nearest airport is Malaga Airport, 22 km from the property.	Расстояние до аэропорта Малаги составляет 22 км.
Featuring a shower, private bathrooms also come with slippers and towels.	К услугам гостей собственная ванная комната с душем, а также тапочками и полотенцами.
Hot Park Water Park is 28 km away.	Аквапарк на горячих термальных источниках «Хот-Парк» находится в 28 км от отеля.
Deluxe Apartment mit Balkon is a self-catering accommodation located in Freiburg im Breisgau.	Апартаменты Deluxe mit Balkon с собственной кухней расположены в городе Фрайбург-им-Брейсгау.
Public parking is possible on site at an additional cost.	За дополнительную плату гости могут пользоваться общественной парковкой.
Bed linen and towels are provided.	Гостям предоставляется постельное белье и полотенца для рук.
Housed in a historic building in Durango’s historic centre, this hotel has free Wi-Fi connection, babysitting services, luggage storage, and meeting rooms.	К услугам гостей отеля Posada San Agustin, расположенного в историческом здании в историческом центре города Дуранго, бесплатный WiFi, камера хранения багажа и конференц-залы. В отеле также предоставляются услуги няни.
Heating and a safe are also provided.	Среди прочих удобств - отопление и сейф.
A public computer station with printing services is available, as well as laundry facilities.	В распоряжении гостей общественный компьютерный терминал с принтером, а также прачечная.
It features a rooftop swimming pool, free Wi-Fi and a buffet restaurant.	К услугам гостей бассейн на крыше, бесплатный WiFi и ресторан с обслуживанием в формате «шведский стол».
Free WiFi is provided throughout the property.	На всей территории работает бесплатный Wi-Fi.
The nearest airport is Côte d'Azur Airport, 22 km from the property.	Расстояние до аэропорта Ницца Лазурный Берег составляет 22 км.
Each room has a seating area and a private bathroom.	В номерах также имеется гостиная зона и собственная ванная комната.
A buffet breakfast is offered each morning at Château Les 4 Saisons and it can also be served in the guest rooms.	Ежедневно в отеле Château Les 4 Saisons сервируется завтрак «шведский стол», а также осуществляется доставка завтрака в номер.
Wow Hills also houses a beautiful outdoor garden with seating areas and barbeque facilities are available upon request.	Рядом с гостевым домом Wow Hills разбит красивый сад с зоной отдыха. По запросу гостям предоставляются принадлежности для приготовления барбекю.
It takes 15 minutes to drive to Belorussky Train Station, from which you can get to Sheremetyevo International Airport by Aeroexpress.	За 15 минут вы доедете до Белорусского железнодорожного вокзала, откуда можно добраться на поезде «Аэроэкспресс» до Международного аэропорта Шереметьево.
Free WiFi is available throughout.	На всей территории можно воспользоваться бесплатным Wi-Fi.
The nearest airport is Marina di Campo Airport, 7 km from Appartamento La Sorgente.	Расстояние от апартаментов La Sorgente до ближайшего аэропорта Эльба составляет 7 км.
Rhinelander/Oneida County Airport is 30 minutes’ drive away. The Lake of the Torches Casino is can be reached in 40 minutes’ drive.	В 30 минутах езды находится аэропорт Райнлендер/Онайда Каунти, а за 40 минут можно доехать до казино Lake of the Torches.
Hotel Cristina overlooks the wonderful Bay of Naples and Mount Vesuvius.	Из отеля Cristina открывается вид на Везувий и живописный Неаполитанский залив.
Traditional Russian food is served in the Vechnyy Zov Hotel’s à la carte restaurant with pretty conservatory.	Гости отеля «Вечный зов» могут посетить ресторан с обслуживанием меню с очаровательным зимним садом, где подают традиционные блюда русской кухни.
A 10-minute walk from the beach, Lakeside Gardens Apartment is located in Bogazici area of Bodrum.	Апартаменты Lakeside Gardens находятся в 10 минутах ходьбы от пляжа в районе Богазичи в Бодруме.
Guests can start their day with a rich buffet breakfast.	Гости могут начать свой день с обильного завтрака "шведский стол".
The next restaurant can be found 1 km from Appartement Schmittenweg and a grocery shop is 1.6 km away.	Ближайший ресторан находится в 1 км от апартаментов Schmittenweg, а расстояние до продуктового магазина составляет 1,6 км.
The French Partridge restaurant offers an à-la-carte menu, including tapas and traditional dishes with a modern twist.	В ресторане отеля French Partridge гостей обслуживают по меню. Здесь вам предложат тапас и традиционные блюда, приготовленные на современный манер.
You can enjoy city view.	Из апартаментов открывается вид на город.
The accommodation provides an equipped kitchen and a seating area.	Дом для отпуска располагает оборудованной кухней и гостиной зоной.
Ferienwohnungen Moosbrugger also includes a terrace.	Кроме того, в комплексе Ferienwohnungen Moosbrugger есть терраса.
Laundry and fax/photocopy services are available as well.	Кроме того, в отеле предоставляются прачечные услуги и услуги факса/ксерокопирования.
Guests can enjoy local dishes at the onsite restaurant.	В ресторане на территории гости смогут заказать блюда местной кухни.
At Apartment Casa Alpina you will find a garden.	На территории здания апартаментов Casa Alpina разбит сад.
The attached bathroom includes hot/cold shower facility, towels and free toiletries.	В собственной ванной комнате с горячим/холодным душем предоставляются полотенца и бесплатные туалетно-косметические принадлежности.
Decorated with white linens and wood furniture, all rooms include ironing facilities.	Каждый номер укомплектован белоснежным постельным бельем и обставлен деревянной мебелью.
The hotel is an ideal base for exploring the beautiful Copper Canyon region.	Отель является идеальной отправной точкой для изучения красивого региона Медного каньона.
Situated 5 minutes’ walk from Kristianstad Train Station, this property offers free Wi-Fi access and rooms with TVs and work desks. Kristianstad Theatre is a 2-minute walk away.	Этот отель типа "постель и завтрак" расположен в 5 минутах ходьбы от железнодорожного вокзала города Кристианстада и в 2 минутах ходьбы от городского театра. К услугам гостей номера с телевизором и рабочим столом, а также бесплатный Wi-Fi.
The nearest airport is Milan Linate Airport, 8 km from B&B La Terrazza Sul Quartiere Isola.	Расстояние от отеля La Terrazza Sul Quartiere Isola до аэропорта Милан Линате составляет 8 км.
Guests can relax in the outdoor hot tub or on the patio under the gazebo.	Также в распоряжении гостей отеля открытая гидромассажная ванна и беседка во внутреннем дворе.
There is a full kitchen with a microwave and an oven in this air-conditioned unit.	В вашем распоряжении полностью оборудованная кухня с микроволновой печью и плитой.
Other facilities offered include a tour desk, dry cleaning and a laundry.	В вашем распоряжении экскурсионное бюро, химчистка и прачечная.
The property offers free parking.	На территории обустроена бесплатная парковка.
The well-lit, spacious rooms with wood floors feature a balcony, flat-screen TV, air conditioning, seating area, wardrobe, minibar and private bathroom.	Просторные и хорошо освещенные номера отеля имеют деревянный пол и располагают балконом, телевизором с плоским экраном, кондиционером, гостиным уголком, шкафом для одежды, мини-баром и собственной ванной комнатой.
Guests of Inn La Cuesta are greeted by a 24-hour reception and the hotel provides free afternoon coffee, tea and cookies.	В отеле Inn La Cuesta работает круглосуточная стойка регистрации, а для гостей предлагается бесплатный послеобеденный кофе, чай и печенье.
Yevpatoriya is 30 km away and the Simferopol Airport is 80 km away.	Расстояние до города Евпатории составляет 30 км, а до аэропорта Симферополя — 80 км.
The chalet also provides free Wi-Fi internet access in the public areas, disability access and a ski locker.	Среди прочих удобств шале — бесплатный Wi-Fi в местах общего пользования и запирающиеся шкафчики для лыж. Шале подходят для гостей с ограниченными физическими возможностями.
The nearest metro station at Kobylisy, on line C, is set 500 metres from Hotel Libuše, and it offers connections towards Prague Main Train Station and the centre of the city.	Расстояние от отеля Libuše до ближайшей станции метро Kobylisy (линия С), от которой можно добраться до Центрального железнодорожного вокзала Праги и центра города, составляет 500 метров.
The spacious, soundproofed rooms feature carpeted floors and large windows.	Гостям предлагается размещение в просторных звукоизолированных номерах с ковровым покрытием и большими окнами.
The property is within a 10-minute walk of Piazza della Signoria square, Uffizi Gallery and Florence Cathedral.	Апартаменты находятся в 10 минутах ходьбы от площади Синьории, галереи Уффици и кафедрального собора Санта-Мария-дель-Фьоре.
There is a shared kitchen at the property.	Среди удобств общая кухня.
Zarzis Airport is 18 km away.	Аэропорт Зарзис находится в 18 км.
Located on top of a dune and commanding pretty sea views, this offers modern rooms with free Wi-Fi.	К услугам гостей этого отеля, расположенного на вершине дюны с прекрасным видом на море, современные номера с бесплатным Wi-Fi.
Shops and restaurants can be found within 1 km and the nearest city, Thisted, is in 20 km.	На расстоянии 1 км работает несколько магазинов и ресторанов, а ближайший город, Тистед, находится в 20 км.
It offers free parking and air-conditioned rooms with satellite TV and free Wi-Fi.	К услугам гостей бесплатная парковка и номера с кондиционером, спутниковым телевидением и бесплатным Wi-Fi.
Set in the Umbrian countryside, Castello Izzalini Todi Resort offers rustic-style apartments.	Загородный дом Castello Izzalini Todi Resort расположен в загородной местности Умбрии. В распоряжении гостей апартаменты в загородном стиле.
Hotel Parque Zabal is located 100 metres from Fusagasuga town centre.	Отель Parque Zabal расположен в 100 метрах от центра города Фусагасуга.
A good selection of restaurants is available in the surrounding area.	В окрестностях расположено множество ресторанов.
The beachfront restaurant serves delicious local and international dishes, and offers free Wi-Fi.	В прибрежном ресторане с бесплатным Wi-Fi подают блюда местной и интернациональной кухни.
All air-conditioned rooms include balcony, a flat-screen cable TV, a phone and a minibar.	Во всех номерах к услугам гостей кондиционер, балкон, телевизор с плоским экраном и кабельными каналами, телефон и мини-бар.
Free WiFi and private parking are also available.	Предоставляется бесплатный Wi-Fi и бесплатная частная парковка.
Featuring a bath or shower, the private bathroom also comes with a hairdryer.	В собственной ванной комнате с ванной или душем предоставляется фен.
There is a full kitchen with a microwave, refrigerator and an oven.	Кроме того, обустроена полностью оборудованная кухня с микроволновой печью, холодильником и духовым шкафом.
Rooms feature views of the swimming pool or the garden, while some also offer a private terrace.	Из окон номеров открывается вид на бассейн или сад, а в некоторых есть собственная терраса.
The nearest airport is Odessa International Airport, 13 km from the property.	Расстояние до международного аэропорта Одессы составляет 13 км.
You will enjoy the restaurant room of the camp park decorated in a nautical style.	Зал ресторана кемпинга оформлен в морском стиле.
It also includes a fridge-freezer and a coffee machine.	К услугам гостей холодильник с морозильной камерой и кофемашина.
Offering an outdoor pool and seasonal outdoor pool, Villa Rosanna is set in Colico in the Lombardy Region, 5 km from Piona Abbey.	Вилла Rosanna расположена в городе Колико, в регионе Ломбардия, в 5 км от аббатства Пиона. К услугам гостей открытый плавательный бассейн и открытый бассейн сезонного использования.
Simply furnished rooms at the guest house offer a fan and shared bathroom with shower facilities.	Гостям номеров, оформленных в лаконичном стиле, предоставляются вентилятор и общая ванная комната с душем.
The hotel can offer vegetarian alternatives and is happy to cater to any dietary requirements with prior request.	Кроме того, в отеле могут приготовить вегетарианские блюда и удовлетворить любые диетические потребности по предварительному запросу.
Bed linen is provided.	Гостям предоставляется постельное белье.
Free Wi-Fi and a flat-screen cable TV are included in all suites.	Во всех люксах в распоряжении гостей бесплатный WiFi и телевизор с 37-дюймовым плоским экраном и кабельными каналами.
A buffet breakfast is available in the hotel’s bright dining room, which features floor-to-ceiling windows.	В светлом обеденном зале отеля, с окнами от пола до потолка, подают завтрак "шведский стол".
Set in the pretty village of Kempsey, The Walter de Cantelupe Inn offers individually decorated, stylish rooms.	Отель типа «постель и завтрак» Walter de Cantelupe Inn расположен в красивой деревне Кемпси. К услугам гостей стильные номера с оригинальным оформлением.
Come and stay in the Hotel Castellina and take it easy in the modern and comfortable rooms.	Отдохните в современных комфортабельных номерах отеля Castellina.
Oristano is 46 km from Sa Lumenaria da Raimonda, while Nuoro is 38 km from the property.	Отель типа «постель и завтрак» Sa Lumenaria da Raimonda находится в 46 км от коммуны Ористано и в 38 км от коммуны Нуоро.
A TV is offered.	В распоряжении гостей телевизор.
At Residenza Ondanomala you will find a garden.	Помимо прочего, при комплексе Residenza Ondanomala разбит сад.
The historical centre of Le Pontet, home place to the Château de Fargues, is within easy reach.	Исторический центр Ле Понте, где расположен замок Шато-де-Фарг, находится в пределах легкой досягаемости.
Park Named after Anna Akhmatova is within a 5-minute walk of the property.	До парка имени Анны Ахматовой можно добраться пешком за 5 минут.
Jenbach can be reached with a unique steam cog railway.	До города Йенбах можно добраться, воспользовавшись уникальным фуникулером на паровой тяге.
Gästehaus Hugo offers a packed lunch service for guests wishing to explore the area.	Гостям, желающим осмотреть окрестности, предлагаются упакованные ланчи.
Campo de’ Fiori square, with its pubs and historic food market is 300 metres away.	На площади Кампо-де-Фьори (в 300 метрах) находятся бары и исторический продовольственный рынок.
The private bathroom is stocked with toiletries and a hairdryer.	В собственной ванной комнате предоставляются туалетно-косметические принадлежности и фен.
The accommodation will provide you with a TV and air conditioning.	Этот дом для отпуска располагает телевизором и кондиционером.
The property offers free parking.	Гостям предоставляется бесплатная парковка.
Featuring free WiFi, Easy Housing offers accommodation in Prague.	Хостел Easy Housing находится в Праге. К услугам гостей бесплатный Wi-Fi.
The shores of Lake Trasimeno can be reached in a 1-hour drive.	Поездка до берега озера Тразимено занимает 1 час.
The property offers free parking.	На территории обустроена бесплатная парковка.
Offering an outdoor pool and an indoor pool, Green Park Punta 2 offers self-catering accommodation 500 metres from Solanas beach area, 5 km from downtown Punta del Este.	Апарт-отель Green Park Punta 2 расположен в 500 метрах от пляжной зоны Соланас и в 5 км от центра города Пунта-дель-Эсте. К услугам гостей крытый и открытый бассейны и апартаменты с собственной кухней.
Staff at the 24-hour front desk readily assists guests with services such as bicycle and car rental, as well as laundry services which include dry cleaning.	Сотрудники круглосуточной стойки регистрации организуют прокат автомобилей и велосипедов, а также услуги прачечной и химчистки.
The classic-style apartment is air conditined and has satellite TV.	Апартаменты оформлены в классическом стиле и оборудованы кондиционером, также подключено спутниковое телевидение.
Bühl train Station is 7 km away, and there is a bus stop directly in front of the guest house.Strasbourg International Airport just 70 km away from the property and Stuttgart Airport is 73 km away.	Местные автобусы останавливаются напротив гостевого дома. Расстояние до железнодорожного вокзала Бюля составляет 7 км, до международного аэропорта Страсбург – 70 км, а до аэропорта Штутгарт – 73 км.
Each room at the Hansestern has a private bathroom and a TV with satellite channels.	Все номера отеля Hansestern располагают собственной ванной комнатой и телевизором со спутниковыми каналами.
Each room has a basin and there are 2 shared bathrooms with a shower for communal use.	Гости могут пользоваться 2 общими ванными комнатами с душем.
Nestled away amidst peaceful nature surroundings, Great Roots Forestry Spa Resort features a hot spring bath and elegantly furnished guestrooms with complimentary bottled water.	Курортный спа-отель Great Roots Forestry расположен в тихом природном месте. К услугам гостей горячие минеральные источники, изысканно оформленные номера и бесплатная бутилированная вода.
At Top Hotel you will find a 24-hour front desk, while there is a vending machine in the lobby.	Стойка регистрации отеля Top работает круглосуточно. В лобби отеля установлен автомат по продаже напитков и закусок.
Garretstown is 20 minutes’ drive from The Old Bank Town House.	Пляж Гарретстаун находится в 20 минутах езды от таунхауса The Old Вank.
Each unit features a flat-screen TV, a fridge, a microwave, a kettle and kitchenware.	Во всех номерах/домах имеются телевизор с плоским экраном, холодильник, микроволновая печь, чайник и кухонные принадлежности.
Hakuba Train Station is a 10-minute drive as well, and the Hakuba Onsen hot springs can be enjoyed a 40-minute drive away.	Также в 10 минутах езды расположен железнодорожный вокзал Хакуба, а в 40 минутах езды - горячие источники Хакуба Онсен.
Featuring modern Thai décor, guest rooms at the hotel have attached bathrooms with hot shower facilities. Each room is equipped with a TV and minibar.	Номера оформлены в современном тайском стиле и располагают ванной комнатой с горячим душем, телевизором и мини-баром.
This property features both free WiFi and free private parking.	На территории обустроена бесплатная частная парковка и предоставляется бесплатный Wi-Fi .
Tripoli Town is 19 km from the property, while Athens City is 160 km away.	Расстояние до Триполи составляет 19 км, а до Афин — 160 км.
The property is 26 km from Klaipėda and boasts views of the garden.	До Клайпеды 26 км. Из окон открывается вид на сад.
There is a flat-screen TV with Freeview and DVD player, hairdryer and tea and coffee facilities in all rooms.	Каждый из них снабжен телевизором с плоским экраном и бесплатными каналами, DVD-плеером, феном и принадлежностями для чая/кофе.
Augusto Cesar Sandino International Airport is 82 km away.	Международный аэропорт имени Аугусто Сесара Сандино находится в 82 км.
Hotel Oceano also boasts its own restaurant, specializing in seafood and international cuisine.	В ресторане отеля Oceano подают блюда из морепродуктов и блюда интернациональной кухни.
Guests can enjoy yoga class or traditional Thai massage, or book boat trips to nearby islands with the resort’s tour desk.	Гости могут посетить занятия йогой, заказать традиционный тайский массаж или организовать лодочную экскурсию на близлежащие острова в туристическом бюро отеля.
Apartment at the Tyrol Landhaus have a south-east facing balcony with mountain views, a kitchenette, seating area, satellite TV and a bathroom with a shower and toilet.	Апартаменты гостевого дома Tyrol Landhaus располагают балконом на юго-восточной стороне с видом на горы, мини-кухней, гостиным уголком, спутниковым телевидением и ванной комнатой с душем и туалетом.
Hotel Cicerone offers free parking, a restaurant and simply furnished rooms with TV and private bathroom.	К услугам гостей отеля Cicerone бесплатная парковка, ресторан и строго обставленные номера с телевизором и собственной ванной комнатой.
Atocha Train Station is 300 metres away, with a high-speed AVE service and links to Barajas Airport.	В 300 метрах от отеля находится железнодорожный вокзал Аточа, откуда отправляются скоростные поезда и поезда до аэропорта Барахас.
Offering free WiFi throughout, Palazzu is a self-catering apartment located in Patrimonio.	Апартаменты Palazzu с собственной кухней и бесплатным Wi-Fi находятся в поселке Патримонио.
The property offers free parking.	К услугам гостей бесплатная парковка.
Cordelia Hotel is situated in Tbilisi, a 3-minute walk away from Saint Trinity Church.	Отель Cordelia расположен в Тбилиси, в 3 минутах ходьбы от Свято-Троицкого собора.
At Tupirmarka Lodge you will find a 24-hour front desk, room service, and a snack bar.	В числе удобств лоджа Tupirmarka круглосуточная стойка регистрации и снэк-бар. Гости могут воспользоваться услугой доставки еды и напитков в номер.
Featuring free WiFi in all areas, Naigao Xiaowo offers accommodation in Shanghai.	Апартаменты Naigao Xiaowo расположены в городе Шанхай. К услугам гостей бесплатный Wi-Fi во всех зонах.
Each has a TV and a private bathroom with shower.	В вашем распоряжении также телевизор и собственная ванная комната с душем.
Your room comes with air conditioning and satellite TV.	Номер оснащен кондиционером и спутниковым телевидением.
They are styled in cream-coloured hues and some of them feature private balconies with seating areas.	Они оформлены в кремовых тонах, в некоторых из них имеются отдельные балконы с гостиной зоной.
The reception team can help guests plan sightseeing trips.	Сотрудники стойки регистрации с радостью помогут гостям спланировать экскурсии.
Some units include a seating area for your convenience.	В числе удобств некоторых номеров — гостиная зона.
Nieuwmarkt as well as Kalverstraat, Hermitage and Rembrandtplein are within 15 minutes walking.	До площади Ниумаркт, торговой улицы Калверштрат, музея Эрмитаж на Амстеле и площади Рембрандта можно дойти менее чем за 15 минут.
The Danube Delta is a natural reserve where you can go fishing, bird watching, take boat rides or simply unwind surrounded by nature.	Дельта Дуная является природным заповедником, в котором можно заняться рыбной ловлей, понаблюдать за птицами, покататься на лодке или просто расслабиться в окружении природы.
The air-conditioned rooms offer a flat-screen TV with cable channels, a desk, fan and seating area.	Номера оснащены кондиционером, телевизором с плоским экраном и кабельными каналами, письменным столом, вентилятором и гостиной зоной.
Each apartment is fitted with a balcony, flat-screen cable TV and safety deposit box.	Каждые апартаменты располагают балконом, сейфом и телевизором с плоским экраном и кабельными каналами.
Located 500 metres from Church of the Savior on Spilled Blood in Saint Petersburg, this apartment features free WiFi. The apartment is 700 metres from Palace Square.	Эти апартаменты с бесплатным Wi-Fi расположены в Санкт-Петербурге, в 500 метрах от храма Спаса-на-Крови и в 700 метрах от Дворцовой площади.
The kitchen includes a dishwasher and oven.	На кухне установлены посудомоечная машина и духовой шкаф.
An array of activities can be enjoyed on site or in the surroundings, including skiing, cycling and horse riding.	Территория и окрестности отлично подходят для активного отдыха, в том числе лыжного спорта, велосипедных прогулок и верховой езды.
Free WiFi is accessible throughout the premises.	На всей территории работает бесплатный Wi-Fi.
They include flat-screen satellite TV, a safe and en-suite bathroom with hairdryer.	В них также имеются такие удобства, как телевизор с плоским экраном и спутниковыми каналами, сейф и ванная комната с феном.
Free WiFi access is available in all areas.	На всей территории работает бесплатный Wi-Fi.
Valledoria is a 17-minute drive from the property, and Porto Torres is 34 km away.	Отель находится в 17 минутах езды от городка Валледории и в 34 км от города Порто-Торреса.
Towels and bed linen are provided in this self-catering accommodation.	Предоставляются полотенца и постельное белье.
The spa offers massages with a view of the sea, a fitness room and aqua gym.	В спа-центре предлагается массаж с видом на море, а также можно посетить фитнес-зал и аквааэробику.
Paignton Bus and Rail Station is only 5 minutes away on foot, and Paignton Pier can be reached in less than a 5-minute walk.	Гостевой дом находится всего в 5 минутах ходьбы от автобусного и железнодорожного вокзалов Пейнтона и менее чем в 5 минутах ходьбы от пристани Пейнтона.
A flat-screen TV is offered.	В числе прочих удобств -— телевизор с плоским экраном.
Organic, locally sourced ingredients are blended in the Mediterranean dishes of its stylish restaurant.	В стильном ресторане отеля подают блюда средиземноморской кухни из органических местных продуктов.
Each room at Sport Hotel comes with a TV with cable channels and a private bathroom with a shower.	Каждый номер в отеле Sport оснащен телевизором с кабельными каналами. В собственной ванной комнате можно принять душ.
Featuring a well-maintained garden, Emerald Residency offers luggage storage and car rental facilities. A tour desk and business centre are also present.	Помимо прочего, разбит ухоженный сад. В гостевом доме Emerald Residency имеется место хранения багажа и работает прокат автомобилей, экскурсионное бюро и бизнес-центр.
Guests can unwind in indoor and outdoor hot spring baths.	Гости могут посетить купальни с водой из горячих источников в помещении и на открытом воздухе.
The apartment features chic décor, high ceilings and a balcony with sea views.	В этих апартаментах с высоким потолком и роскошным декором есть балкон с видом на море.
You can engage in various activities, such as horse riding, windsurfing and cycling.	В окрестностях есть все условия для активного отдыха, включая виндсерфинг, верховую езду и велосипедные прогулки.
Breakfast is served in the garden, in the rooms or in the dining area.	Завтрак сервируют в саду, в номерах или в обеденной зоне.
A dishwasher is also available.	Также установлена посудомоечная машина.
Macedonia International Airport is 130 km away.	Расстояние до международного аэропорта «Македония» составляет 130 км.
All units also include a private bathroom with shower equipped with a hairdryer.	Все номера располагают собственной ванной комнатой с душем и феном.
Guest House Jam features free WiFi throughout the property.	На всей территории гостевого дома Jam работает бесплатный Wi-Fi.
Free private parking is available on site.	На территории обустроена бесплатная частная парковка.
There is also a terrace.	Кроме того, обустроена терраса.
Located on the 4th floor with no lift, this apartment features a kitchenette is fitted with a dishwasher and a microwave, as well as a coffee machine and a kettle.	Апартаменты находятся на 5 этаже здания без лифта. В числе удобств мини-кухня с посудомоечной машиной, микроволновой печью, кофемашиной и чайником.
The beach in Canneto is 15 minutes' drive away.	Поездка до пляжа Каннето занимает 15 минут.
Other facilities offered include a shared lounge and a games room.	Гости могут посетить общий лаундж и игровую комнату.
There is also a floral garden and a children’s playground.	Возле отеля разбит сад с цветниками, и обустроена детская игровая площадка.
Apartments at La Ferula come with a flat-screen TV, kitchen and dining area.	Апартаменты комплекса La Ferula располагают телевизором с плоским экраном, кухней и обеденной зоной.
A selection of restaurants and bars are located in the surrounding streets.	На близлежащих улицах открыто множество разнообразных ресторанов и баров.
Apache Gold Casino is 5 minutes’ drive from the hotel.	Поездка до казино Apache Gold занимает 5 минут.
Staff can arrange boat trips around the Gulf of Trieste.	Персонал может организовать экскурсии на корабле вокруг залива Триеста.
Located opposite the Hartford-Brainard Airport, this Days Inn Hartford is 6 minutes’ drive from the Connecticut Convention Center and Trinity College is 3 miles away.	Отель Days Inn Hartford находится напротив аэропорта Хартфорд-Брейнард, в 6 минутах езды от конгресс-центра Коннектикута и в 4,8 км от Тринити-колледжа.
Rooms include a private bathroom equipped with shower and free toiletries.	К услугам гостей собственная ванная комната с душем и бесплатными туалетно-косметическими принадлежностями.
Pueblo Antiguo and Café Britt coffee plantation are a 10-minute drive from the hotel, and the Poas Volcano is a 40-minute drive away.	Отель Country Inns & Suites by Carlson расположен в 40 минутах езды от вулкана Поас и в 10 минутах езды от парка Пуэбло Антигуо и кофейной плантации Кафе-Бритт.
At a surcharge guests can have breakfast at Meriton Old Town Garden Cafe which is located next door.	За отдельную плату для гостей сервируют завтрак в соседнем кафе Meriton Old Town Garden.
Simferopol Airport is 70 km away.	Расстояние до аэропорта Симферополь составляет 70 км.
Breakfast is served daily in a café just 20 metres from the hotel.	Завтрак подается каждый день в кафе всего в 20 метрах от отеля.
Mobile homes are modern and come with a bathroom with shower.	В современных передвижных домах также имеется ванная комната с душем.
At Riverside Garden Villas, you will find a hot tub, a 24-hour front desk and a peaceful garden.	В комплексе вилл Riverside Garden в распоряжении гостей гидромассажная ванна, круглосуточная стойка регистрации и тихий сад.
Restaurants and a supermarket are 1 km away.	В 1 км от апартаментов работают рестораны и супермаркет.
The island’ port is accessible within a short drive and Naxos National Airport is approximately 3 km away.	Поездка от гостевого дома до порта острова займет несколько минут, а Национальный аэропорт Наксоса находится примерно в 3 км.
Appartement CA200 in Cannes is located just 500 metres from the beach and features a terrace and garden.	Апартаменты CA200 расположены в Каннах, всего в 500 метрах от пляжа. К услугам гостей терраса и сад.
With a Moroccan-style décor, all the air-conditioned rooms at Riad Rime offer a TV and a wardrobe. A private bathroom with a shower is also provided.	В распоряжении гостей каждого оформленного в марокканском стиле номера риада Rime — кондиционер, телевизор, шкаф для одежды и собственная ванная комната с душем.
Ski Lodge is a holiday home located in the centre of Brides-les-Bains, a 2-minute walk from Olympe Gondola.	Дом для отпуска Ski Lodge находится в центре горнолыжного курорта Брид-ле-Бен, в 2 минутах ходьбы от гондольного подъемника Олимп.
This hotel is located in Herrieden.	Отель Genießerhotel Limbacher находится в городе Херриден.
Free on-site parking is available for cars, trucks, and buses at Bay City Regency Inn.	На территории мотеля Bay City Regency оборудована бесплатная парковка для автомобилей, грузовиков и автобусов.
Slippers are provided and most rooms have great mountain views.	Гостям предоставляются тапочки. Из большинства номеров открывается великолепный вид на горы.
Palace Jasmine is 15 km from Trivandrum International Airport.	Отель Palace Jasmine находится в 15 км от международного аэропорта Тривандрума.
Area activities include hiking and day trips along the Golden Circle.	Гости могут отправиться в пешие походы и однодневные поездки по Золотому кольцу Исландии.
The property offers free parking.	Также обустроена бесплатная парковка.
An array of activities can be enjoyed on site or in the surroundings, including cycling, hiking and canoeing.	На территории комплекса Miejsce Fajne и за его пределами гости могут заняться велосипедными и пешими прогулками, а также греблей на каноэ.
A daily breakfast is offered which guests can enjoy in the bright breakfast area, also with lake views.	Завтрак подается ежедневно в светлом зале для завтраков с видом на озеро.
Being in the centre of Ciampino you are surrounded by cafés and restaurants.	Отель расположен в центре Чампино, где работает множество кафе и ресторанов.
The kitchen is equipped with a dishwasher.	Кухня оснащена посудомоечной машиной.
Only 100 metres from the shores of the Black Sea, this cosy pension offers air-conditioned rooms and free Wi-Fi.	Уютный мотель Side расположен всего в 100 м от берега Черного моря. К услугам гостей номера с кондиционером и бесплатным Wi-Fi.
Located in the town of Tinos, Athos Studios is only 50 metres from Kalamia Beach and features a bar.	Отель Athos Studios с собственным баром расположен в городе Тинос, всего в 50 метрах от пляжа Каламия.
Enjoying a waterfront position just 100 metres from the pebbly beach, Hotel Soan is 3 km from the centre of Sarandë.	Отель Soan находится на побережье, всего в 100 метрах от галечного пляжа и в 3 км от центра города Саранда.
All units come with a furnished balcony or terrace.	Все номера комплекса оборудованы меблированным балконом или террасой.
An array of activities can be enjoyed on site or in the surroundings, including hiking.	На территории дома для отпуска или в его окрестностях можно заняться различными видами активного отдыха, в том числе пешим туризмом.
An array of activities can be enjoyed on site or in the surroundings, including table tennis.	Рядом с домом для отпуска и в окружающем регионе можно заняться различными видами активного отдыха, в том числе поиграть в настольный теннис.
Just a short walk away, guests can also find a super market, where they can buy their daily necessities.	Всего в нескольких минутах ходьбы также работает супермаркет, где продаются товары повседневного спроса.
An array of activities can be enjoyed on site or in the surroundings, including skiing, cycling and hiking.	В окрестностях лоджа созданы отличные условия для пеших походов, катания на велосипеде, лыжного спорта и других видов активного отдыха.
The property is situated at the foot of the Mystic Mirnock Mountain which has numerous cycling and hiking routes.	Апарт-отель расположен у подножия горы Мистик Мирнок, на которой проложены многочисленные велосипедные и пешеходные дорожки.
Entertainment is provided on most week nights.	Почти каждый вечер в отеле проводятся развлекательные мероприятия.
Cunda's centrum is 1.5 km, and Ayvalik city centre is 2 km from the property.	Центр Кунды находится в 1,5 км от гостевого дома, а центр города Айвалык - в 2 км.
There is a 24-hour front desk at the property.	Стойка регистрации работает круглосуточно.
Opéra Garnier is 2.6 km from Petit Trianon-Etoile, while Orsay Museum is 2.7 km from the property.	Апартаменты расположены в 2,6 км от театра Гранд-опера и в 2,7 км от музея Орсе.
Alicante Airport can be reached by car in 1 hour.	Поездка до аэропорта Аликанте займет 1 час.
Located in the Copacabana district of Rio de Janeiro, the Hotel Biarritz invites you to rest in accommodations equipped with king-size beds and air conditioning.	Отель Biarritz расположен в районе Копакабана в Рио-де-Жанейро. Приглашаем вас отдохнуть в номерах, оборудованных кроватями "king-size" и кондиционером.
This Islamic hotel offers separate outdoor pools for men and women, and a terrace overlooking the sea.	Этот мусульманский отель располагает отдельными открытыми бассейнами для мужчин и женщин, а также террасой с видом на море.
ACC Liverpool is 3.2 km from Sefton Grange , while Liverpool Echo Arena is 3.2 km from the property.	Выставочный и конференц-центр ACC Liverpool, а также спортивно-развлекательный комплекс Echo Arena расположены в 3,2 км от гостевого дома Sefton Grange.
Private parking is available on site.	Гостям предоставляется частная парковка на территории.
This country house is 70 km from Federico Garcia Lorca Granada-Jaen Airport.	Этот загородный дом находится в 70 км от аэропорта им. Федерико Гарсиа Лорки Гранада-Хаэн.
Some rooms are fitted with traditional futon bedding, while others have Western beds.	В некоторых номерах уложены традиционные матрасы футоны, а в других установлены кровати в западном стиле.
The Sport Vital Hotel’s sports programme includes guided hiking and mountain bike tours, aqua gymnastics, and activities such as yoga and pilates.	Спортивная программа спорт-отеля Vital включает организованные походы и туры на горных велосипедах, аквааэробику, а также занятия йогой и пилатесом.
All guests can enjoy panoramic mountain views from their south-west facing balcony.	Балкон в апартаментах выходит на юго-запад. С балкона открывается панорамный вид на горы.
It features a luxury spa centre and rooms with an LCD TV and free WiFi access.	К услугам гостей номера, оснащенные ЖК-телевизором и бесплатным Wi-Fi, а также роскошный спа-центр.
There is a spacious lounge to spend time with friends and a small Library Lounge where guests can read a good book and have a cup of coffee or tea.	Гости могут провести время с друзьями в просторном лаундже или почитать книгу и выпить чашечку кофе или чая в небольшом лаундже с библиотекой.
A Continental breakfast buffet with fresh breads, pastries, fruits, cereals and sliced cold meats is offered for GBP 9.50.	По утрам для гостей сервируется континентальный завтрак «шведский стол», состоящий из булочек, выпечки, фруктов, мюслей и мясного ассорти. Стоимость завтрака составляет 9,5 фунтов стерлингов.
Apartments Hollaj is set in a peaceful part of Ulcinj, only 200 metres from Small Beach and pine forest.	Апартаменты Hollaj расположены в тихой части города Улцинь, всего в 200 метрах от пляжа Смол-Бич и соснового леса.
Guests have access to free WiFi in all areas and free public parking is available on site.	Во всех зонах действует бесплатный Wi-Fi. На территории обустроена бесплатная общественная парковка.
Bed linen and towels are provided.	Гостям предоставляются полотенца и постельное белье.
All apartments have a private furnished balcony and a kitchen with dining area.	Во всех апартаментах в вашем распоряжении собственный меблированный балкон и кухня с обеденной зоной.
All rooms offer splendid garden views.	Из каждого номера открывается великолепный вид на сад.
Located 200 metres from Caicó's AABB, Pousada Bom Gosto offers free Wi-Fi in public areas, 24-hour front desk service and a restaurant.	Гостевой дом Pousada Bom Gosto находится в 200 метрах от спортивно-развлекательного комплекса AABB в городе Кайко. К услугам гостей бесплатный Wi-Fi в местах общего пользования, круглосуточная стойка регистрации и ресторан.
Each room at this inn is air-conditioned and has a flat-screen cable TV and a kettle.	В числе удобств номеров кондиционер, телевизор с плоским экраном и кабельными каналами, а также чайник.
The accommodation features a large garden and a shared lounge with TV.	К услугам гостей большой сад и общий лаундж с телевизором.
Each offers a spacious living room with a flat-screen TV, while the kitchen includes an oven, a stove and a fridge.	Все они располагают просторной гостиной с телевизором с плоским экраном, а также кухней с духовкой, плитой и холодильником.
All rooms at The Denman include central heating, cable TV and a DVD player.	Во всех номерах отеля Denman в распоряжении гостей центральное отопление, кабельное телевидение и DVD-плеер.
At Pichepehuen guests will find barbecue and laundry facilities.	Гости дома для отпуска Pichepehuen могут воспользоваться стиральной машиной и принадлежностями для барбекю.
Simonovskiy Val Apartment offers accommodation in Moscow. The apartment is 3.8 km from Gorky Park.	Апартаменты «Симоновский вал» расположены в Москве, в 3,8 км от парка имени Горького.
The rooms are built out of natural materials like brick, wood and bamboo.	Номера построены с применением натуральных материалов, включая кирпич, дерево и бамбук.
There is also a kitchen, equipped with an oven. A refrigerator and stovetop are also offered, as well as a kettle.	Кухня укомплектована духовкой, холодильником, плитой и чайником.
At Aix Suite Location you will find a garden and a terrace.	На территории здания апартаментов Aix Suite Location разбит сад и обустроена терраса.
From the property, the popular Tower Bridge and Tower of London are 2.3 miles away and Cambridge Heath Train Station is a 5-minute walk to the north.	Расстояние до популярного Тауэрского моста и Тауэра составляет 3,7 км, а до железнодорожного вокзала Кембридж-Хит следует пройти в северном направлении всего 5 минут.
It consists of sweet food including croissants and cappuccino.	Он состоит из сладких блюд и включает круассаны с капучино.
The restaurant serves multi cuisine dishes, including Indian, Chinese and western choices.	В ресторане подаются блюда интернациональной кухни, в том числе блюда индийской, китайской и западной кухонь.
The property is situated in a convenient location close to attractions such as Blue Mosque and Hagia Sophia.	Дом находится в удобном месте, рядом с такими достопримечательностями, как Голубая мечеть и собор Святой Софии.
Local restaurants and supermarkets can be reached on foot in 5 minutes. Trogir city centre and the marina are a 15-minute walk away.	Местные рестораны и супермаркеты расположены в 5 минутах ходьбы от апартаментов. До центра города Трогир и порта можно дойти за 15 минут.
This family-run hotel is located 3 km from Leipzig Central Train Station and 5 minutes’ drive from Leipzig city centre.	Этот семейный гостевой дом находится в 3 км от центрального железнодорожного вокзала Лейпцига, в 5 минутах езды от центра города Лейпцига.
Chinatown is 13 minutes’ walk away.	Прогулка до Китайского квартала занимает 13 минут.
Located near national highways, the guesthouse is a 17-minute drive to Águeda, a 22-minute drive to Aveiro and a 40-minute drive to Coimbra.	Гостевой дом находится рядом с национальными автомагистралями, в 17 минутах езды от города Агеда, в 22 минутах от города Авейру и в 40 минутах езды от первой столицы Португалии - города Коимбры.
Each room comes with satellite TV, a minibar and a bathroom with a hairdryer and a shower or a tub.	Все номера располагают телевизором со спутниковыми каналами, мини-баром и ванной комнатой с феном и душем или ванной.
This medieval-themed hostal offers personalised rooms a shared lounge with a fireplace and flat-screen TV.	Гостевой дом оформлен в средневековом стиле. В нем есть индивидуально декорированные номера с общей гостиной, камином и телевизором с плоским экраном.
The nearest airport is Ben Gurion Airport, 19 km from the property.	До аэропорта имени Бен-Гуриона — 19 км.
The Sklep 57 has a garden, children’s playground, a bike storage room and free on-site parking for up to 4 cars.	Кроме того, в числе удобств дома для отпуска Sklep 57 сад, детская игровая площадка, помещение для хранения велосипедов и бесплатная парковка вместимостью до 4 автомобилей.
Pianeta Oro Avamposto Meteo also includes a sun terrace.	К услугам гостей комплекса Pianeta Oro Avamposto Meteo терраса для загара.
A fitness centre and swimming pool are available and free of charge.	Фитнес-центр и бассейн можно посещать бесплатно.
Ben Siesta provides excellent facilities and affordable luxury in serene surroundings, plus the comfort of home.	Прекрасно оснащенные апартаменты Ben Siesta - это сочетание доступной роскоши, спокойной атмосферы и домашнего уюта.
All apartments at Lapland Hotel Ounasvaara Chalets feature a private terrace and a living room with satellite TV.	Во всех апартаментах Lapland Ounasvaara Chalets имеется собственная терраса и гостиная со спутниковым телевидением.
Le Clos du Père Finet B&B is just over a 10-minute drive from Redu.	От гостевого дома типа «постель и завтрак» Le Clos du Père Finet - чуть более 10 минут езды до деревни Редю.
Offering light, elegant rooms and a 2 AA Rosette restaurant, Yeovil Court is less than 10 minutes’ drive from Yeovil’s centre.	В отеле к услугам гостей светлые, элегантные номера и 2 ресторана, удостоенных розочки ресторанного гида Автомобильной Ассоциации Великобритании. Отель Yeovil Court находится менее чем в 10 минутах езды от центра Йеавила.
A 1-minute walk from Shiomi Train Station, APA Hotel Tokyo Shiomi Ekimae offers western-style rooms with free wired internet and WiFi access.	В отеле APA Tokyo Shiomi Ekimae, расположенном в 1 минуте ходьбы от железнодорожного вокзала Сиоми, к услугам гостей номера в западном стиле с бесплатным проводным доступом в Интернет и Wi-Fi.
German beers and wines can be enjoyed on the terrace or in the conservatory.	На террасе или в зимнем саду можно приятно провести время за кружкой немецкого пива или бокалом вина.
Set within an impressive turreted granite building in the exclusive West End of Aberdeen, these fully-serviced luxury suites have been awarded 4 Diamonds from the RAC.	Отель расположен в величественном гранитном здании с башенкой в фешенебельном районе на западе Абердина. Он удостоен 4 "алмазов" по рейтингу RAC. К услугам гостей роскошные люксы с полным обслуживанием.
All units share bathroom facilities.	Все номера располагают общими ванными комнатами.
The bathroom includes bath, shower, bidet and a hairdryer.	В ванной комнате есть ванна, душ, биде и фен.
Horse riding is available on site and free parking is also provided.	На территории фермы желающие могут заняться конным спортом. Предусмотрена бесплатная парковка.
The Sanctuary Lounge offers refreshing cocktails and various dishes in a buffet or à la carte style.	В лаундже Sanctuary подают освежающие коктейли и разнообразные блюда в формате "шведского стола" или по меню.
Kings Lynn Golf Club is 1.5 miles away and historical Castle Rising can be reached in 5 minutes’ drive.	До гольф-клуба Кингс Линн 2,5 км, а до исторического замка Рост можно доехать за 5 минут.
With a rustic feel and wood beamed ceilings, every apartment features a seating area and dining table.	В числе удобств апартаментов в деревенском стиле с балочным потолком гостиный уголок и обеденный стол.
Traditional cuisine can be sampled in La Quietat’s on-site restaurant.	В ресторане на территории отеля La Quietat подают блюда традиционной кухни.
The spacious restaurant serves Hungarian cuisine.	В просторном ресторане подают блюда венгерской кухни.
Lake Geneva and Nyon are both an 8-minute drive away.	Поездка до Женевского озера и Ньона занимает 8 минут.
Talamanca Beach is 150 metres away.	Пляж Таламанка находится в 150 метрах.
Located in the centre of town, Warrego Hotel Motel Cunnamulla features a restaurant and air-conditioned rooms with a flat-screen TV.	Отель и мотель Warrego Cunnamulla находится в центре города. К услугам гостей ресторан и номера с кондиционером и телевизором с плоским экраном.
Towels are featured.	Гостям предоставляются полотенца.
A continental breakfast is served every morning.	Каждое утро гостям сервируют континентальный завтрак.
All units open to a balcony with unobstructed sea views.	Во всех апартаментах имеется балкон, откуда открывается прекрасный вид на море.
Free Parking is also available.	Гостям, путешествующим на автомобиле, предоставляется бесплатная парковка.
The gym’s fitness instructors can advise and help guests reach their goals.	Фитнес-инструкторы в тренажерном зале всегда готовы помочь гостям подобрать правильную нагрузку.
Located in Moraira, just 600 metres form Cala del Portitxolet Beach, Villa Oceano holiday home offers a beautiful garden, a covered terrace with barbecue facilities and an outdoor pool.	Дом для отпуска Villa Oceano находится в городе Морайра, всего в 600 метрах от пляжа Кала-дель-Портитксолет. К вашим услугам красивый сад, крытая терраса с принадлежностями для барбекю и открытый бассейн.
Offering an outdoor pool, barbecue and sun terrace, Pera Villalari is set in Kemer in the Mediterranean Region Turkey Region.	Вилла Pera Villalari с открытым бассейном и террасой для загара находится в курортном городе Кемер Средиземноморского региона Турции. Гости могут воспользоваться принадлежностями для барбекю.
There is also a kitchen, fitted with an oven and fridge.	В числе удобств кухня с духовкой и холодильником.
A seating area and private bathroom with shower and hairdryer are included.	В числе удобств гостиная зона и собственная ванная комната с душем и феном.
The nearest airport is Tbilisi International Airport, 11 km from Lilika Apartment at Shoropani.	Расстояние от апартаментов «Лилика на ул. Шорапани» до международного аэропорта Тбилиси составляет 11 км.
Toulon is 47 km from Villa Valdor.	Тулон находится в 47 км от виллы Valdor.
Some rooms are complete with a spa bath.	В некоторых номерах имеется гидромассажная ванна.
Free Wi-Fi access is provided.	Предоставляется бесплатный Wi-Fi.
A bicycle can be rented at an additional cost.	За дополнительную плату можно воспользоваться прокатом велосипедов.
Lek House comfortable rooms with a cable TV.	Постояльцам гостевого дома Lek House предлагается проживание в комфортабельных номерах с кабельным телевидением.
The rooms come with a TV and a private bathroom.	В номерах в распоряжении гостей телевизор и собственная ванная комната.
The nearest airport is Malaga Airport, 22 km from the property.	Расстояние до аэропорта Малаги составляет 22 км.
Featuring a shower, private bathrooms also come with slippers and towels.	К услугам гостей собственная ванная комната с душем, а также тапочками и полотенцами.
Hot Park Water Park is 28 km away.	Аквапарк на горячих термальных источниках «Хот-Парк» находится в 28 км от отеля.
Deluxe Apartment mit Balkon is a self-catering accommodation located in Freiburg im Breisgau.	Апартаменты Deluxe mit Balkon с собственной кухней расположены в городе Фрайбург-им-Брейсгау.
Public parking is possible on site at an additional cost.	За дополнительную плату гости могут пользоваться общественной парковкой.
Bed linen and towels are provided.	Гостям предоставляется постельное белье и полотенца для рук.
Housed in a historic building in Durango’s historic centre, this hotel has free Wi-Fi connection, babysitting services, luggage storage, and meeting rooms.	К услугам гостей отеля Posada San Agustin, расположенного в историческом здании в историческом центре города Дуранго, бесплатный WiFi, камера хранения багажа и конференц-залы. В отеле также предоставляются услуги няни.
Heating and a safe are also provided.	Среди прочих удобств - отопление и сейф.
A public computer station with printing services is available, as well as laundry facilities.	В распоряжении гостей общественный компьютерный терминал с принтером, а также прачечная.
It features a rooftop swimming pool, free Wi-Fi and a buffet restaurant.	К услугам гостей бассейн на крыше, бесплатный WiFi и ресторан с обслуживанием в формате «шведский стол».
Free WiFi is provided throughout the property.	На всей территории работает бесплатный Wi-Fi.
The nearest airport is Côte d'Azur Airport, 22 km from the property.	Расстояние до аэропорта Ницца Лазурный Берег составляет 22 км.
Each room has a seating area and a private bathroom.	В номерах также имеется гостиная зона и собственная ванная комната.
A buffet breakfast is offered each morning at Château Les 4 Saisons and it can also be served in the guest rooms.	Ежедневно в отеле Château Les 4 Saisons сервируется завтрак «шведский стол», а также осуществляется доставка завтрака в номер.
Wow Hills also houses a beautiful outdoor garden with seating areas and barbeque facilities are available upon request.	Рядом с гостевым домом Wow Hills разбит красивый сад с зоной отдыха. По запросу гостям предоставляются принадлежности для приготовления барбекю.
It takes 15 minutes to drive to Belorussky Train Station, from which you can get to Sheremetyevo International Airport by Aeroexpress.	За 15 минут вы доедете до Белорусского железнодорожного вокзала, откуда можно добраться на поезде «Аэроэкспресс» до Международного аэропорта Шереметьево.
Free WiFi is available throughout.	На всей территории можно воспользоваться бесплатным Wi-Fi.
The nearest airport is Marina di Campo Airport, 7 km from Appartamento La Sorgente.	Расстояние от апартаментов La Sorgente до ближайшего аэропорта Эльба составляет 7 км.
Rhinelander/Oneida County Airport is 30 minutes’ drive away. The Lake of the Torches Casino is can be reached in 40 minutes’ drive.	В 30 минутах езды находится аэропорт Райнлендер/Онайда Каунти, а за 40 минут можно доехать до казино Lake of the Torches.
Hotel Cristina overlooks the wonderful Bay of Naples and Mount Vesuvius.	Из отеля Cristina открывается вид на Везувий и живописный Неаполитанский залив.
Traditional Russian food is served in the Vechnyy Zov Hotel’s à la carte restaurant with pretty conservatory.	Гости отеля «Вечный зов» могут посетить ресторан с обслуживанием меню с очаровательным зимним садом, где подают традиционные блюда русской кухни.
A 10-minute walk from the beach, Lakeside Gardens Apartment is located in Bogazici area of Bodrum.	Апартаменты Lakeside Gardens находятся в 10 минутах ходьбы от пляжа в районе Богазичи в Бодруме.
Guests can start their day with a rich buffet breakfast.	Гости могут начать свой день с обильного завтрака "шведский стол".
The next restaurant can be found 1 km from Appartement Schmittenweg and a grocery shop is 1.6 km away.	Ближайший ресторан находится в 1 км от апартаментов Schmittenweg, а расстояние до продуктового магазина составляет 1,6 км.
The French Partridge restaurant offers an à-la-carte menu, including tapas and traditional dishes with a modern twist.	В ресторане отеля French Partridge гостей обслуживают по меню. Здесь вам предложат тапас и традиционные блюда, приготовленные на современный манер.
You can enjoy city view.	Из апартаментов открывается вид на город.
The accommodation provides an equipped kitchen and a seating area.	Дом для отпуска располагает оборудованной кухней и гостиной зоной.
Ferienwohnungen Moosbrugger also includes a terrace.	Кроме того, в комплексе Ferienwohnungen Moosbrugger есть терраса.
Laundry and fax/photocopy services are available as well.	Кроме того, в отеле предоставляются прачечные услуги и услуги факса/ксерокопирования.
Guests can enjoy local dishes at the onsite restaurant.	В ресторане на территории гости смогут заказать блюда местной кухни.
At Apartment Casa Alpina you will find a garden.	На территории здания апартаментов Casa Alpina разбит сад.
The attached bathroom includes hot/cold shower facility, towels and free toiletries.	В собственной ванной комнате с горячим/холодным душем предоставляются полотенца и бесплатные туалетно-косметические принадлежности.
Decorated with white linens and wood furniture, all rooms include ironing facilities.	Каждый номер укомплектован белоснежным постельным бельем и обставлен деревянной мебелью.
The hotel is an ideal base for exploring the beautiful Copper Canyon region.	Отель является идеальной отправной точкой для изучения красивого региона Медного каньона.
Situated 5 minutes’ walk from Kristianstad Train Station, this property offers free Wi-Fi access and rooms with TVs and work desks. Kristianstad Theatre is a 2-minute walk away.	Этот отель типа "постель и завтрак" расположен в 5 минутах ходьбы от железнодорожного вокзала города Кристианстада и в 2 минутах ходьбы от городского театра. К услугам гостей номера с телевизором и рабочим столом, а также бесплатный Wi-Fi.
The nearest airport is Milan Linate Airport, 8 km from B&B La Terrazza Sul Quartiere Isola.	Расстояние от отеля La Terrazza Sul Quartiere Isola до аэропорта Милан Линате составляет 8 км.
Guests can relax in the outdoor hot tub or on the patio under the gazebo.	Также в распоряжении гостей отеля открытая гидромассажная ванна и беседка во внутреннем дворе.
There is a full kitchen with a microwave and an oven in this air-conditioned unit.	В вашем распоряжении полностью оборудованная кухня с микроволновой печью и плитой.
Other facilities offered include a tour desk, dry cleaning and a laundry.	В вашем распоряжении экскурсионное бюро, химчистка и прачечная.
The property offers free parking.	На территории обустроена бесплатная парковка.
The well-lit, spacious rooms with wood floors feature a balcony, flat-screen TV, air conditioning, seating area, wardrobe, minibar and private bathroom.	Просторные и хорошо освещенные номера отеля имеют деревянный пол и располагают балконом, телевизором с плоским экраном, кондиционером, гостиным уголком, шкафом для одежды, мини-баром и собственной ванной комнатой.
Guests of Inn La Cuesta are greeted by a 24-hour reception and the hotel provides free afternoon coffee, tea and cookies.	В отеле Inn La Cuesta работает круглосуточная стойка регистрации, а для гостей предлагается бесплатный послеобеденный кофе, чай и печенье.
Yevpatoriya is 30 km away and the Simferopol Airport is 80 km away.	Расстояние до города Евпатории составляет 30 км, а до аэропорта Симферополя — 80 км.
The chalet also provides free Wi-Fi internet access in the public areas, disability access and a ski locker.	Среди прочих удобств шале — бесплатный Wi-Fi в местах общего пользования и запирающиеся шкафчики для лыж. Шале подходят для гостей с ограниченными физическими возможностями.
The nearest metro station at Kobylisy, on line C, is set 500 metres from Hotel Libuše, and it offers connections towards Prague Main Train Station and the centre of the city.	Расстояние от отеля Libuše до ближайшей станции метро Kobylisy (линия С), от которой можно добраться до Центрального железнодорожного вокзала Праги и центра города, составляет 500 метров.
The spacious, soundproofed rooms feature carpeted floors and large windows.	Гостям предлагается размещение в просторных звукоизолированных номерах с ковровым покрытием и большими окнами.
The property is within a 10-minute walk of Piazza della Signoria square, Uffizi Gallery and Florence Cathedral.	Апартаменты находятся в 10 минутах ходьбы от площади Синьории, галереи Уффици и кафедрального собора Санта-Мария-дель-Фьоре.
There is a shared kitchen at the property.	Среди удобств общая кухня.
Zarzis Airport is 18 km away.	Аэропорт Зарзис находится в 18 км.
Located on top of a dune and commanding pretty sea views, this offers modern rooms with free Wi-Fi.	К услугам гостей этого отеля, расположенного на вершине дюны с прекрасным видом на море, современные номера с бесплатным Wi-Fi.
Shops and restaurants can be found within 1 km and the nearest city, Thisted, is in 20 km.	На расстоянии 1 км работает несколько магазинов и ресторанов, а ближайший город, Тистед, находится в 20 км.
It offers free parking and air-conditioned rooms with satellite TV and free Wi-Fi.	К услугам гостей бесплатная парковка и номера с кондиционером, спутниковым телевидением и бесплатным Wi-Fi.
Set in the Umbrian countryside, Castello Izzalini Todi Resort offers rustic-style apartments.	Загородный дом Castello Izzalini Todi Resort расположен в загородной местности Умбрии. В распоряжении гостей апартаменты в загородном стиле.
Hotel Parque Zabal is located 100 metres from Fusagasuga town centre.	Отель Parque Zabal расположен в 100 метрах от центра города Фусагасуга.
A good selection of restaurants is available in the surrounding area.	В окрестностях расположено множество ресторанов.
The beachfront restaurant serves delicious local and international dishes, and offers free Wi-Fi.	В прибрежном ресторане с бесплатным Wi-Fi подают блюда местной и интернациональной кухни.
All air-conditioned rooms include balcony, a flat-screen cable TV, a phone and a minibar.	Во всех номерах к услугам гостей кондиционер, балкон, телевизор с плоским экраном и кабельными каналами, телефон и мини-бар.
Free WiFi and private parking are also available.	Предоставляется бесплатный Wi-Fi и бесплатная частная парковка.
Featuring a bath or shower, the private bathroom also comes with a hairdryer.	В собственной ванной комнате с ванной или душем предоставляется фен.
There is a full kitchen with a microwave, refrigerator and an oven.	Кроме того, обустроена полностью оборудованная кухня с микроволновой печью, холодильником и духовым шкафом.
Rooms feature views of the swimming pool or the garden, while some also offer a private terrace.	Из окон номеров открывается вид на бассейн или сад, а в некоторых есть собственная терраса.
The nearest airport is Odessa International Airport, 13 km from the property.	Расстояние до международного аэропорта Одессы составляет 13 км.
You will enjoy the restaurant room of the camp park decorated in a nautical style.	Зал ресторана кемпинга оформлен в морском стиле.
It also includes a fridge-freezer and a coffee machine.	К услугам гостей холодильник с морозильной камерой и кофемашина.
Offering an outdoor pool and seasonal outdoor pool, Villa Rosanna is set in Colico in the Lombardy Region, 5 km from Piona Abbey.	Вилла Rosanna расположена в городе Колико, в регионе Ломбардия, в 5 км от аббатства Пиона. К услугам гостей открытый плавательный бассейн и открытый бассейн сезонного использования.
Simply furnished rooms at the guest house offer a fan and shared bathroom with shower facilities.	Гостям номеров, оформленных в лаконичном стиле, предоставляются вентилятор и общая ванная комната с душем.
The hotel can offer vegetarian alternatives and is happy to cater to any dietary requirements with prior request.	Кроме того, в отеле могут приготовить вегетарианские блюда и удовлетворить любые диетические потребности по предварительному запросу.
Bed linen is provided.	Гостям предоставляется постельное белье.
Free Wi-Fi and a flat-screen cable TV are included in all suites.	Во всех люксах в распоряжении гостей бесплатный WiFi и телевизор с 37-дюймовым плоским экраном и кабельными каналами.
A buffet breakfast is available in the hotel’s bright dining room, which features floor-to-ceiling windows.	В светлом обеденном зале отеля, с окнами от пола до потолка, подают завтрак "шведский стол".
Set in the pretty village of Kempsey, The Walter de Cantelupe Inn offers individually decorated, stylish rooms.	Отель типа «постель и завтрак» Walter de Cantelupe Inn расположен в красивой деревне Кемпси. К услугам гостей стильные номера с оригинальным оформлением.
Come and stay in the Hotel Castellina and take it easy in the modern and comfortable rooms.	Отдохните в современных комфортабельных номерах отеля Castellina.
Oristano is 46 km from Sa Lumenaria da Raimonda, while Nuoro is 38 km from the property.	Отель типа «постель и завтрак» Sa Lumenaria da Raimonda находится в 46 км от коммуны Ористано и в 38 км от коммуны Нуоро.
A TV is offered.	В распоряжении гостей телевизор.
At Residenza Ondanomala you will find a garden.	Помимо прочего, при комплексе Residenza Ondanomala разбит сад.
The historical centre of Le Pontet, home place to the Château de Fargues, is within easy reach.	Исторический центр Ле Понте, где расположен замок Шато-де-Фарг, находится в пределах легкой досягаемости.
Park Named after Anna Akhmatova is within a 5-minute walk of the property.	До парка имени Анны Ахматовой можно добраться пешком за 5 минут.
Jenbach can be reached with a unique steam cog railway.	До города Йенбах можно добраться, воспользовавшись уникальным фуникулером на паровой тяге.
Gästehaus Hugo offers a packed lunch service for guests wishing to explore the area.	Гостям, желающим осмотреть окрестности, предлагаются упакованные ланчи.
Campo de’ Fiori square, with its pubs and historic food market is 300 metres away.	На площади Кампо-де-Фьори (в 300 метрах) находятся бары и исторический продовольственный рынок.
The private bathroom is stocked with toiletries and a hairdryer.	В собственной ванной комнате предоставляются туалетно-косметические принадлежности и фен.
The accommodation will provide you with a TV and air conditioning.	Этот дом для отпуска располагает телевизором и кондиционером.
The property offers free parking.	Гостям предоставляется бесплатная парковка.
Featuring free WiFi, Easy Housing offers accommodation in Prague.	Хостел Easy Housing находится в Праге. К услугам гостей бесплатный Wi-Fi.
The shores of Lake Trasimeno can be reached in a 1-hour drive.	Поездка до берега озера Тразимено занимает 1 час.
The property offers free parking.	На территории обустроена бесплатная парковка.
Offering an outdoor pool and an indoor pool, Green Park Punta 2 offers self-catering accommodation 500 metres from Solanas beach area, 5 km from downtown Punta del Este.	Апарт-отель Green Park Punta 2 расположен в 500 метрах от пляжной зоны Соланас и в 5 км от центра города Пунта-дель-Эсте. К услугам гостей крытый и открытый бассейны и апартаменты с собственной кухней.
Staff at the 24-hour front desk readily assists guests with services such as bicycle and car rental, as well as laundry services which include dry cleaning.	Сотрудники круглосуточной стойки регистрации организуют прокат автомобилей и велосипедов, а также услуги прачечной и химчистки.
The classic-style apartment is air conditined and has satellite TV.	Апартаменты оформлены в классическом стиле и оборудованы кондиционером, также подключено спутниковое телевидение.
Bühl train Station is 7 km away, and there is a bus stop directly in front of the guest house.Strasbourg International Airport just 70 km away from the property and Stuttgart Airport is 73 km away.	Местные автобусы останавливаются напротив гостевого дома. Расстояние до железнодорожного вокзала Бюля составляет 7 км, до международного аэропорта Страсбург – 70 км, а до аэропорта Штутгарт – 73 км.
Each room at the Hansestern has a private bathroom and a TV with satellite channels.	Все номера отеля Hansestern располагают собственной ванной комнатой и телевизором со спутниковыми каналами.
Each room has a basin and there are 2 shared bathrooms with a shower for communal use.	Гости могут пользоваться 2 общими ванными комнатами с душем.
Nestled away amidst peaceful nature surroundings, Great Roots Forestry Spa Resort features a hot spring bath and elegantly furnished guestrooms with complimentary bottled water.	Курортный спа-отель Great Roots Forestry расположен в тихом природном месте. К услугам гостей горячие минеральные источники, изысканно оформленные номера и бесплатная бутилированная вода.
At Top Hotel you will find a 24-hour front desk, while there is a vending machine in the lobby.	Стойка регистрации отеля Top работает круглосуточно. В лобби отеля установлен автомат по продаже напитков и закусок.
Garretstown is 20 minutes’ drive from The Old Bank Town House.	Пляж Гарретстаун находится в 20 минутах езды от таунхауса The Old Вank.
Each unit features a flat-screen TV, a fridge, a microwave, a kettle and kitchenware.	Во всех номерах/домах имеются телевизор с плоским экраном, холодильник, микроволновая печь, чайник и кухонные принадлежности.
Hakuba Train Station is a 10-minute drive as well, and the Hakuba Onsen hot springs can be enjoyed a 40-minute drive away.	Также в 10 минутах езды расположен железнодорожный вокзал Хакуба, а в 40 минутах езды - горячие источники Хакуба Онсен.
Featuring modern Thai décor, guest rooms at the hotel have attached bathrooms with hot shower facilities. Each room is equipped with a TV and minibar.	Номера оформлены в современном тайском стиле и располагают ванной комнатой с горячим душем, телевизором и мини-баром.
This property features both free WiFi and free private parking.	На территории обустроена бесплатная частная парковка и предоставляется бесплатный Wi-Fi .
Tripoli Town is 19 km from the property, while Athens City is 160 km away.	Расстояние до Триполи составляет 19 км, а до Афин — 160 км.
The property is 26 km from Klaipėda and boasts views of the garden.	До Клайпеды 26 км. Из окон открывается вид на сад.
There is a flat-screen TV with Freeview and DVD player, hairdryer and tea and coffee facilities in all rooms.	Каждый из них снабжен телевизором с плоским экраном и бесплатными каналами, DVD-плеером, феном и принадлежностями для чая/кофе.
Augusto Cesar Sandino International Airport is 82 km away.	Международный аэропорт имени Аугусто Сесара Сандино находится в 82 км.
Hotel Oceano also boasts its own restaurant, specializing in seafood and international cuisine.	В ресторане отеля Oceano подают блюда из морепродуктов и блюда интернациональной кухни.
Guests can enjoy yoga class or traditional Thai massage, or book boat trips to nearby islands with the resort’s tour desk.	Гости могут посетить занятия йогой, заказать традиционный тайский массаж или организовать лодочную экскурсию на близлежащие острова в туристическом бюро отеля.
Apartment at the Tyrol Landhaus have a south-east facing balcony with mountain views, a kitchenette, seating area, satellite TV and a bathroom with a shower and toilet.	Апартаменты гостевого дома Tyrol Landhaus располагают балконом на юго-восточной стороне с видом на горы, мини-кухней, гостиным уголком, спутниковым телевидением и ванной комнатой с душем и туалетом.
Hotel Cicerone offers free parking, a restaurant and simply furnished rooms with TV and private bathroom.	К услугам гостей отеля Cicerone бесплатная парковка, ресторан и строго обставленные номера с телевизором и собственной ванной комнатой.
Atocha Train Station is 300 metres away, with a high-speed AVE service and links to Barajas Airport.	В 300 метрах от отеля находится железнодорожный вокзал Аточа, откуда отправляются скоростные поезда и поезда до аэропорта Барахас.
Offering free WiFi throughout, Palazzu is a self-catering apartment located in Patrimonio.	Апартаменты Palazzu с собственной кухней и бесплатным Wi-Fi находятся в поселке Патримонио.
The property offers free parking.	К услугам гостей бесплатная парковка.
The modern Apartament Lawendowy is located in the centre of Stronie Śląskie, 5 km from the Czarna Góra Ski Complex.	Современные апартаменты Lawendowy находятся в центре Строне-Сленске, в 5 км от горнолыжного комплекса Чарна-Гура.
Guests can enjoy sea and pool views.	Вы можете полюбоваться видом на море и бассейн.
This property offers free parking.	Кроме того, гостям предоставляется бесплатная парковка.
At The Ritz-Carlton Dubai, guests can experience varieties of themed restaurants ranging from flavors of Asia, Arabia and the Mediterranean including the new beach restaurant Palm Grill overlooking the Arabian Gulf.	В отеле The Ritz-Carlton Dubai работает несколько тематических ресторанов, в которых подаются блюда азиатской, арабской и средиземноморской кухни. Из нового пляжного ресторана Palm Grill открывается вид на Персидский залив.
Providing a living room with sofas and a fireplace, the accommodation also offers a terrace.	В шале имеется терраса и гостиная с диванами и камином.
Boat trips, island visits, snorkelling and diving can all be arranged locally.	На месте могут быть организованы морские прогулки, экскурсии на острова, подводное плавание и дайвинг.
It offers free Wi-Fi, a varied breakfast and rustic-style accommodation.	По утрам гостям подают разнообразный завтрак. Предоставляется бесплатный WiFi.
Laundry and fax/photocopy services are available at the front desk.	Услуги прачечной и факса/ксерокса предлагаются на стойке регистрации.
The bar serves drinks well into the evening.	В баре до позднего вечера предлагаются напитки.
The rooms here will provide you with a seating area.	Номера располагают гостиной зоной.
The Warth-Schröcken Ski Area, with a connection via a ski lift to Lech, is 25 km away.	Горнолыжный курорт Варт-Шрёккен с подъемником к Леху находится в 25 км от апартаментов.
Other facilities offered include a shared lounge with library.	Среди прочих удобств общий лаундж с библиотекой.
Located in Pantai Cenang, Chenang Purplish Guest Room d' Langkawi offers one-bedroom chalets with free WiFi and free private parking.	Комплекс Chenang Purplish Guest Room d'Langkawi расположен в курортном поселке Пантай-Сенанг. Гостям предоставляются шале с 1 спальней и бесплатным Wi-Fi, а также места на бесплатной частной парковке.
Dijon is a 45-minute drive away and Autun is a 35-minute drive from the hotel.	Поездка на машине до города Дижон займет 45 минут, а до города Отен — 35 минут.
The air-conditioned rooms of Sun Maritim feature carpeted floors and wooden furniture.	Гостям отеля Sun Maritim предлагаются номера с кондиционером, ковровым покрытием и деревянной мебелью.
A full kitchen and a private entrance are included.	Имеются плностью оборудованная кухня и отдельный вход.
A range of drinks is provided at the bar.	В баре представлен широкий ассортимент напитков.
The en suite bathroom comes with a shower and hairdryer.	В ванной комнате с душем предоставляется фен.
The heated guest rooms are fitted with electric blankets, a fridge and ironing equipment. The en suite bathroom offers free toiletries and a hairdryer.	В номерах с отоплением имеется холодильник, гладильные принадлежности, электрические одеяла, а также ванная комната с бесплатными туалетно-косметическими принадлежностями и феном.
You can engage in various activities, such as snorkeling, diving and cycling.	Рядом с домом имеются условия для различных видов активного отдыха, таких как сноркелинг, дайвинг и велосипедные прогулки.
The private bathroom includes free toiletries and a hairdryer.	В собственной ванной комнате предоставляется фен и бесплатные туалетно-косметические принадлежности.
Private parking is free of charge on site.	На территории обустроена бесплатная частная парковка.
Rooms come with a private bathroom offering shower facility and free toiletries.	Собственная ванная комната с душем укомплектована бесплатными туалетно-косметическими принадлежностями.
Guests can visit the Unicus’s top-class restaurant, offering delicious dishes by an award-winning chef.	Гости могут посетить первоклассный ресторан отеля Unicus, где предлагаются вкусные блюда от шеф-повара, удостоенного различных наград.
It provides free Wi-Fi access and parking.	К услугам гостей бесплатный Wi-Fi и парковка.
Ironing facilities can be provided.	Гостям предоставляются гладильные принадлежности.
At Spinnaker House you will find a courtyard garden.	В апартаментах Spinnaker House имеется сад во внутреннем дворике.
It offers free Wi-Fi, a restaurant and a tour desk which organises excursions to local attractions.	К услугам гостей бесплатный Wi-Fi, ресторан и туристическое бюро, где организуются экскурсии к местным достопримечательностям.
All rooms are decorated in a classic style, and fitted with tiled floors and wooden furnishings.	Номера с выложенными плиткой полами оформлены в классическом стиле и обставлены деревянной мебелью.
Bolzano, the provincial capital, is 12 km from the hotel.	Расстояние до города Больцано, административного центра одноименной провинции, составляет 12 км.
At Summerfield Green Bungalow you will facilities like grocery deliveries, a shared lounge and an ironing service are offered.	При бунгало Summerfield Green работает ресторан. Предусмотрены услуги доставки продуктов и глажки; обустроен общий лаундж.
Guests can reach Palm Jumeirah with a 10 minutes' drive.	Поездка до острова Палм-Джумейра занимает 10 минут.
Featuring a terrace with panoramic views and a garden, Colonica Fontisterni is a house set in Donnini.	Дом для отпуска Colonica Fontisterni расположен в городке Доннини. В распоряжении гостей сад и терраса с панорамным видом.
Only 100 metres from San Cristobal Hill, Apart Hotel Visandell offers self-catering apartments with free Wi-Fi and private terraces in Providencia. It features a swimming pool, and free parking is provided.	Апарт-отель Visandell расположен всего в 100 метрах от горы Сан-Кристобаль в коммуне Провиденсия. К услугам гостей апартаменты с собственной кухней, бесплатным WiFi и частной террасой, а также бассейн и бесплатная парковка.
Set in an 18th-century wine-making château, this B&B is 2 km from the centre of Saint-Estèphe, in the wine region of Médoc.	Этот отель типа "постель и завтрак" располагается в винодельческой усадьбе XVIII века, в 2 км от центра Сент-Эстеф, в винодельческом регионе Медок.
You can visit some of Galicia’s charming fishing towns such as Sanxenxo, Combarro or Marín, which are less than 30 minutes’ drive away.	Вы можете посетить один из очаровательных рыбацких городов Галичины, таких как Санхенхо, Комбарро или Марин. До них можно доехать за полчаса.
Guincho beach is a 10-minute drive from the Sea at Your Fingertips apartment, and guests will find Quinta da Marinha Golf Club 3.7 km away.	До пляжа Гиншу можно доехать от апартаментов Sea at Your Fingertips за 10 минут, а расстояние до гольф-клуба Quinta da Marinha составляет 3,7 км.
Slots At Sudbury Downs is 26 km away.	Расстояние до ипподрома Садбери Даунс составляет 26 км.
There is a sandbox in the yard.	Во дворе разбита песочница.
WiFi, continental breakfast and on-site parking are also offered.	Также в распоряжении гостей Wi-Fi, континентальный завтрак и парковка на территории.
Valgrande Pajares Ski Resort is 30 km from Hostel Albergue de Columbiello.	Горнолыжный курорт Вальгранде-Пахарес находится в 30 км от хостела Albergue de Columbiello.
The Quinta da Foz includes a spacious common living room with sofas, TV and board games.	В фермерском доме Quinta da Foz обустроена просторная общая гостиная с диванами, телевизором и настольными играми.
Extras include a fan.	Также в числе удобств вентилятор.
Guests can sing karaoke at the Golden Emperor International Club.	Гости могут попеть в караоке в клубе Golden Emperor International.
Tbilisi International Airport is 15 km from Lions Hotel.	Расстояние от отеля Lions до международного аэропорта Тбилиси составляет 15 км.
Hepburn Regional Park is a 25-minute drive away.	Поездка до регионального парка Хепберна занимает 25 минут.
Balcony On Sixth Lodge is just a 3-minute walk from Murray Bridge Railway Station.	Прогулка от мотеля Balcony On Sixth Lodge до железнодорожного вокзала Марри-Бридж займет всего 3 минуты ходьбы.
Guests can enjoy the on-site restaurant. Free private parking is available on site.	К услугам гостей терраса для загара, ресторан и бесплатная частная парковка.
Sun Moon Lake Hotel has a business centre with meeting facilities.	В числе удобств отеля Sun Moon Lake — бизнес-центр с помещениями для совещаний.
Guests can walk around the garden or the farm, which includes a vegetable garden, fruit trees, and animals.	Гости могут прогуляться по саду или ферме с огородом, фруктовыми деревьями и животными.
The pools are surrounded by loungers and there are large sun terraces.	Вокруг бассейнов расставлены шезлонги. Гости могут отдыхать на больших террасах для загара.
Batumi International Airport is 6.6 km from the property.	В 6,6 км расположен международный аэропорт Батуми.
Charming Studio Apartment is a self-catering accommodation located in Rio de Janeiro. Free WiFi access is available.	Апартаменты-студио Charming с собственной кухней и бесплатным Wi-Fi расположены в Рио-де-Жанейро.
A free shuttle service, a gift shop and safety deposit boxes are also available on site.	В числе удобств бесплатный трансфер, сувенирный магазин и сейф.
An iron, ironing board, coffee-tea-facilities and desk.	Также в распоряжении гостей утюг, гладильная доска, принадлежности для чая/кофе и письменный стол.
Known as the Golden Cape, the popular Zlatni Rat beach area is just 1.5 km from Bolbeach Guesthouse.	Расстояние от дома Bolbeach до популярной пляжной зоны «Золотой мыс» составляет 1,5 км.
Some come with a balcony and a mountain view.	В некоторых номерах есть балкон с видом на горы.
Free WiFi is available throughout the property.	На всей территории апартаментов предоставляется бесплатный Wi-Fi.
Akranes Rooms is located in Akranes, West Iceland, 42 km from Reykjavík.	Гостевой дом Akranes Rooms расположен в городе Акранес в Западной Исландии, в 42 км от Рейкьявика.
Within 400 m shops can be found.	Расстояние до магазинов составляет 400 м.
The property offers free parking and is approximately a 4-hour drive from Buenos Aires.	На территории обустроена бесплатная парковка. Поездка до Буэнос-Айреса занимает примерно 4 часа.
Staff at IH Hotels Firenze Business can provide tips on how to move in and around Florence.	Сотрудники отеля IH Firenze Business предоставят гостям информацию о том, как добраться до различных мест во Флоренции и ее окрестностях.
The guest house also offers bike hire and car hire.	Организуется прокат автомобилей и велосипедов.
Breakfast is served here in the summer months.	Кроме того, летом завтрак подаётся в саду.
Scenically located beside the Agger River in Lohmar, Aggerschlösschen offers a beer garden, beach bar, and free WiFi access.	Отель Aggerschlösschen расположен в живописном месте у реки Аггер в городе Ломар. К услугам гостей пивной сад и пляжный бар. На территории работает бесплатный Wi-Fi.
Airport shuttle can be arranged at a surcharge.	За дополнительную плату может быть организован трансфер от/до аэропорта.
Plečnik house museum is 300 meters away.	До дома-музея Плечника — 300 м.
Chenonceau Chateau is 22 minutes by car and Tours is a 31-minute drive.	До замка Шенонсо можно доехать на машине за 22 минуты, а до Тура — за 31 минуту.
It offers comfortable accommodation with free Wi-Fi and a private balcony.	Гостям предлагаются комфортабельные номера с бесплатным Wi-Fi и балконом.
There are 4 restaurants with special menus for children.	Работают 4 ресторана со специальными меню для детей.
Ramajal Rural is in the countryside in the Las Hurdes region of Extremadura.	Комплекс апартаментов Ramajal Rural находится в загородной местности района Лас-Урдес автономии Эстремадура.
The Lincolnshire Oak is surrounded by nearly 1.5 acres of grounds and gardens and offers traditional quality, comfort and value.	Отель Lincolnshire Oak окружен собственной территорией и садами площадью 0,6 га. Гостей отеля ожидает традиционное качество, комфорт и выгодные цены.
It is a 5-minute walk from Monte-Carlo’s Casino and a 10-minute walk from the beach.	Апарт-отель расположен в 5 минутах ходьбы от казино Монте-Карло и в 10 минутах ходьбы от пляжа.
Uzhgorod Castle is 1.2 km from the hotel, and Uzhgorod Drama Theater is a 15-minute walk away.	Ужгородский замок находится в 1,2 км, а прогулка до драматического театра Ужгорода займет 15 минут.
You will find a 24-hour front desk with luggage storage and currency exchange services at the property.	В распоряжении гостей круглосуточная стойка регистрации, камера хранения багажа и пункт обмена валюты.
Spacious, elegant rooms with free Wi-Fi and city views are offered here.	Гостей ожидают просторные, элегантные номера с бесплатным Wi-Fi и видом на город.
Guests enjoy good transport links around town.	В этом районе налажено хорошее транспортное сообщение по городу.
Every room is equipped with a private bathroom. Extras include free toiletries and a hair dryer.	В числе удобств собственная ванная комната с феном и бесплатными туалетно-косметическими принадлежностями.
Astali Hotel is situated only 100 metres from Rethymno’s beach and 200 metres from the Old Town.	Отель Astali расположен всего в 100 метрах от пляжа Ретимно и в 200 метрах от Старого города.
Scenic views and international food can be enjoyed at the hotel’s roof-top restaurant.	В ресторане на крыше отеля, откуда открывается живописный вид, подают блюда интернациональной кухни.
A variety of taverns and bars lies within walking distance.	Прогулка до разнообразных таверн и баров занимает лишь несколько минут.
Skiathos Airport is located 1.5 km from the property.	Расстояние до Национального аэропорта остров Скиатос составляет 1,5 км.
The Millstätter See Golf Course and the Goldeck Ski Area are both 7 km away.	Апартаменты находятся в 7 км от поля для гольфа Millstätter See и горнолыжного курорта Гольдек.
Transfers from and to the airports are available for an additional charge.	Трансфер от/до аэропортов предоставляется за дополнительную плату.
Hollywood Restaurant serves Chinese, Indian and Continental dishes.	В ресторане Hollywood подают блюда китайской, индийской и континентальной кухни.
The Marmara serves buffet breakfast in its main restaurant.	В главном ресторане этого курортного отеля подается завтрак «шведский стол».
Just 200 metres from the beach, Pensione Villa Elena is located in Forte dei Marmi.	Гостевой дом Villa Elena находится в небольшом городе Форте-дей-Марми, всего в 200 метрах от пляжа.
The India Gate is 16 km while Red Fort is 22 km.	В 16 км находятся Ворота Индии, а в 22 км — Красный форт.
Villa Julia features free WiFi .	Гостям виллы Julia предоставляется бесплатный Wi-Fi.
The nearest airport is Chania International Airport, 27 km from the property.	Расстояние до международного аэропорта Ханьи, ближайшего к комплексу, составляет 27 км.
Laleli Tram Stop is 150 metres from the hotel, and it is just 2 stops from Sultanahmet Tram Stop.	Трамвайная остановка Laleli находится в 150 метрах от отеля. Отсюда всего 2 остановки до трамвайной остановки Sultanahmet.
Located in Kota Kinabalu, Dorcas Service Apartment (Marina Court) offers an outdoor swimming pool and a fitness centre.	Апартаменты Dorcas Service Apartment (Marina Court) находятся в Кота-Кинабалу и располагают открытым бассейном и фитнес-центром.
Bremen Airport is 4 km away.	Расстояние до аэропорта Бремена составляет 4 км.
Set on the 1st floor of an Austro-Hungarian style villa in Opatija, Apartment Milani is bright and spacious and offers a terrace and free WiFi access.	Просторные и светлые апартаменты Milani с террасой и бесплатным WiFi расположены в городе Опатия, на 2 этаже здания виллы, выполненной в Австро-Венгерском стиле.
Free WiFi is available in the restaurant, where guests can enjoy the continental breakfast that is served.	В ресторане с бесплатным Wi-Fi подается континентальный завтрак.
Those wishing to explore the surrounding countryside will find the Mechta Nature Reserve is only 8 km away.	Гости, желающие осмотреть окрестности, могут посетить заповедник «Мечта», расположенный всего в 8 км.
Free WiFi is provided .	Работает бесплатный Wi-Fi.
Guests are welcome to take advantage of the large garden at the property with its furnished terrace, children’s playground and barbecue facilities.	Вокруг гостевого дома разбит большой сад с меблированной террасой, детской игровой площадкой и принадлежностями для приготовления барбекю.
The bright rooms at Saarland Hotel - Restaurant Milano come with a seating, a desk and a TV. A hairdryer is provided in the en suite bathroom.	В каждом из светлых номеров отеля Saarland обустроена собственная ванная комната с феном. В числе прочих удобств — мягкая мебель, рабочий стол и телевизор.
Hotel Continentale is 200 metres from Castro Pretorio Metro Station and 5 minutes’ walk from Termini Train Station.	Отель Continentale находится в 200 метрах от станции метро Castro Pretorio и в 5 минутах ходьбы от железнодорожного вокзала Термини.
Hairdryers are also available on request.	По запросу предоставляются фены.
The nearest airport is Miami International Airport, 14 km from Sunshine Apartments.	Расстояние до международного аэропорта Майами, ближайшего к комплексу апартаментов Sunshine, составляет 14 км.
Meribel, Courchevel and Les Menuires ski resort are all within a 40-minute drive.	В 40 минутах езды от отеля расположены лыжные курорты Мерибель, Куршевель и Ле Менуир.
Guests can take advantage of the free weekday newspapers and fax and copying services which are both located in the lobby.	В будние дни гостям предоставляются бесплатные газеты, при необходимости можно пользоваться услугами факса и ксерокса, которые расположены в лобби.
The Anne Frank House is a 5-minute walk.	Прогулка до дома Анны Франк займет 5 минут.
A flat-screen TV is provided in the living room.	В гостиной установлен телевизор с плоским экраном.
Each room comes with a dressing room and a private bathroom with a shower.	В каждом номере ботеля есть гардеробная и собственная ванная комната с душем.
The nearest airport is Rijeka Airport, 11 km from the property.	Расстояние до аэропорта Риеки составляет 11 км.
A range of extras can be arranged including massages and wine and candles on arrival.	Для желающих могут быть организованы различные дополнительные услуги, в том числе сеансы массажа. По прибытии гостям предлагается приветственный подарок: свечи и вино.
The Tazewell Motor Lodge is 10 minutes’ drive from Lincoln Memorial University.	Мотель Tazewell Motor Lodge с бесплатным WiFi находится в 10 минутах езды от Мемориального университета Линкольна.
Ticketing and sightseeing arrangement services are provided at the tour desk.	В туристическом бюро можно приобрести билеты и заказать экскурсии.
Located in Tukums in the Zemgale Region, 46 km from Jūrmala, Guest House Saulgrieži boasts a sauna and indoor pool.	Гостевой дом Saulgrieži находится в городе Тукумс, область Земгале, в 46 км от города Юрмалы. К услугам гостей сауна и крытый бассейн.
Albergo Il Cacciatore offers large rooms and a terrace overlooking the Umbrian valley.	В отеле Albergo Il Cacciatore к услугам гостей просторные номера с видом на долину Умбрии.
Armenian specialities are served in elegant Haykanoush restaurant, where the traditional carpets contrast with the modern furniture and chandeliers.	В элегантном ресторане "Айкануш", где традиционные ковры контрастируют с современной мебелью и люстрами, подают фирменные блюда армянской кухни.
The apartment features a patio with seats.	Апартаменты также располагают меблированным внутренним двориком.
Stolpnik Church is a 15-minute walk away.	Церковь Столпника находится в 15 минутах ходьбы.
Mountain biking and hiking trails are located a short distance from the hotel.	Недалеко от отеля пролегают туристические тропы и маршруты для катания на горном велосипеде.
This rustic guest house is set in Andorra La Vella’s Old Town.	Это загородный гостевой дом расположен в Старом городе Андорра-ла-Вельи.
All rooms are heated and soundproofed.	Все номера звукоизолированы и отапливаются.
At Taba Paradise Resort you can take a swim in the heated swimming pool or relax by the garden or terrace.	Гости курортного отеля Taba Paradise могут искупаться в бассейне с подогревом, а также расслабиться в саду или на террасе.
Car rentals and shuttle services are arranged upon request.	По запросу предоставляется услуга трансфера и прокат автомобилей.
The property is 900 metres from Pärnu City Center and 500 metres from Pärnu Golf Club.	Апартаменты находятся в 900 метрах от центра города Пярну и в 500 метрах от гольф-клуба Пярну.
Arzon’s marina is a lively area where you will find many bars, restaurants and shops.	Порт Арзона - это оживленный район с многочисленными барами, ресторанами и магазинами.
The B&B can help guests to organize their visit to the Capital of Europe.	В отеле типа "постель и завтрак" гостям помогут организовать их визит в столице Европы.
Several cafés and supermarkets are also located in the surroundings of the accommodation.	Несколько кафе и супермаркетов находится в непосредственной близости от апартаментов.
Rijeka Airport is 16 km away.	Расстояние до аэропорта Риеки составляет 16 км.
The 5 private bathrooms include a hairdryer and bathrobes.	Собственная ванная комната укомплектована феном и халатами.
Situated right on the beach of Skinos in Plakias Village, On the Rocks offers rooms that open to a furnished balcony, enjoying unobstructed Libyan Sea views.	Отель On the Rocks находится прямо на пляже Скинос в деревне Плакиас. Из номеров есть выход на меблированный балкон, с которого открывается панорамный вид на Ливийское море.
The two-bedroom apartments come with a fully equipped kitchen, a dining area, a seating area with a sofa, and a private bathroom with a bath or shower.	В апартаментах с 2 спальнями в вашем распоряжении полностью оборудованная кухня, кухня, обеденная зона, гостиный уголок с диваном и собственная ванная комната с ванной или душем.
An array of activities can be enjoyed on site or in the surroundings, including diving.	На территории виллы и в близлежащем районе можно заняться различными видами активного отдыха, в том числе дайвингом.
High-speed internet access is also offered here.	К услугам гостей высокоскоростной доступ в Интернет.
The B&B is located on the third floor of a block of apartments.	Этот отель типа «постель и завтрак» занимает 4 этаж многоквартирного дома.
Sennaya 5 Apartment is a self-catering accommodation located in Saint Petersburg, right in front of Sadovaya, Spasskaya and Sennaya Ploshchad Metro Stations.	Апартаменты «Сенная 5» с собственной кухней находятся в Санкт-Петербурге, рядом со станциями метро Садовая, Спасская и Сенная площадь.
Bed linen and towels are included.	Полотенца и постельное белье включены в стоимость проживания.
You can engage in various activities, such as cycling, fishing and hiking.	В окрестностях популярны рыбная ловля, а также пешие и велосипедные прогулки.
The property also offers grocery deliveries and laundry facilities.	Предоставляются услуги доставки продуктов и прачечной.
Enjoying a quiet location, Penzion u Konicka is set 300 metres from the Prostějov’s centre.	Отель Penzion u Konicka расположен в тихом месте, в 300 метрах от центра города Простеёв.
Offering a restaurant, Borg Al Eiwan Hotel Apartment offers self-catering accommodation. Free WiFi access is available in all areas.	К услугам гостей апарт-отеля Borg Al Eiwan апартаменты с собственной кухней, ресторан и бесплатный Wi-Fi на всей территории.
In the surrounding area it is also possible to find a variety of restaurants and cafés.	В окрестностях также можно найти множество ресторанов и кафе.
There is also a bar, shared lounge and a games room at the hotel.	В отеле также имеется бар, общий лаундж и игровая комната.
A convenience shop is on site.	На территории отеля работает магазин.
They also come with a radio and a telephone.	Также в номерах есть радио и телефон.
Penzion U Petry is 10 km from the Nové Hamry Ski Area, while Boží Dar Ski Area is 30 km away.	Пансион U Petry находится в 10 км от горнолыжного курорта Нове-Хамри, а горнолыжный курорт Божий Дар находится в 30 км.
Various restaurants can be found in the vicinity.	Неподалеку расположены разнообразные рестораны.
Set along one of the so-called Lorcan Routes, the property offers easy access to sights relevant to the life and works of the poet and playwright, Federico García Lorca.	Этот гостевой дом расположен у так называемого «Пути Лорки» — вы можете посетить места, где жил и творил великий поэт и драматург Федерико Гарсиа Лорка.
A shuttle to Faro Airport, just 30 minutes’ drive, is available on request.	По запросу организуется трансфер до аэропорта Фаро, находящийся в 30 минутах езды от виллы.
There is dry cleaning services at the property.	Гости могут воспользоваться услугами химчистки.
The Vlasska’s apartments are located in 4 buildings, sharing the garden and the courtyard.	Апартаменты Vlasska расположены в 4 зданиях с общим садом и внутренним двором.
Zeko Rozat Guesthouse is 8 km from Dubrovnik city centre and 10 km from Banje Beach. Arborteum Trsteno is 12 km away.	Центр Дубровника начинается в 8 км от гостевого дома Zeko Rozat, а в 10 км пролегает пляж Банье. В 12 км находится дендрарий Трстено.
A TV, fridge and work desk await guests in each of the air-conditioned, colourful rooms at the Galant Hotel. Many include a seating area and classical-style curtains.	Кондиционированные и красочные номера отеля "Галант" имеют телевизор, холодильник и письменный стол. Многие номера располагают гостиной и шторами в классическом стиле.
Casa di Nina is 2 km from Avignon and the Papal Palace, and 4 km from the train station.	Вилла Casa di Nina находится в 2 км от Авиньона и Папского дворца и в 4 км от железнодорожного вокзала.
Collaven Manor is in the North West of Dartmoor.	Отель Collaven Manor находится на северо-западе Дартмура.
The property is well placed for horse-riding, canoeing and archery, as well as scuba diving and golf at the nearby 18-hole Puntaldia golf club.	В отеле гости могут заняться верховой ездой, греблей на каноэ, стрельбой из лука, дайвингом и гольфом в близлежащем 18-луночном гольф-клубе Puntaldia.
You can enjoy a mountain view from the balcony with furniture.	С меблированного балкона открывается вид на горы.
Parking is free.	Гостям предоставляется бесплатная парковка.
Within a short walking distance, you will find several restaurants and cafeterias.	В нескольких минутах ходьбы работает несколько ресторанов и кафе.
Local tram and bus stops are just a few minutes’ walk away from Apartments Habicum, while the city centre is within 10 minutes' drive.	Остановки местных трамваев и автобусов находятся всего в нескольких минутах ходьбы от апартаментов Habicum, а до центра города можно доехать за 10 минут.
It has an outdoor swimming pool, gym and free Wi-Fi.	К услугам гостей открытый бассейн, тренажерный зал и бесплатный Wi-Fi.
Free WiFi access is available in this homestay.	К услугам гостей бесплатный WiFi.
The private bathroom includes a bathtub.	В собственной ванной комнате установлена ванна.
Some units are air conditioned and include a seating area with a flat-screen TV. Some units also have a kitchen, equipped with a dishwasher.	В некоторых апартаментах есть кондиционер, а в гостином уголке установлен телевизор с плоским экраном. Гости нескольких апартаментов пользуются собственной кухней с посудомоечной машиной.
At Setomaa Turismitalo you will find barbecue facilities.	На территории имеются принадлежности для барбекю.
Restaurants and bars are available within a 10-minute walk.	Прогулка до ресторанов и баров занимает 10 минут.
24-hour reception services are offered at Beloit Ike’s Motel.	Стойка регистрации мотеля Beloit Ike's работает круглосуточно.
Within 15 minutes on foot, the St. Nedelya Church and the TZUM Shopping Mall can both be reached.	До церкви Св. Недели и торгового центра ЦУМ можно дойти за 15 минут пешком.
Laundry facilities are provided on site and the hotel can arrange overnight camel trips across the sand dunes.	В отеле предоставляются услуги прачечной и организуются ночные поездки на верблюдах через песочные дюны.
It features an outdoor heated swimming pool surrounded with sun loungers.	На территории отеля гостей ждет открытый плавательный бассейн с подогревом, вокруг которого установлены шезлонги.
Set 700 metres from Dolphinarium in Batumi, this apartment features free WiFi.	Эти апартаменты с бесплатным Wi-Fi расположены в городе Батуми, в 700 метрах от дельфинария.
Located in Jutigny, Gite le Moulin du Gouaix offers a self-catering house with a private garden and BBQ facilities.	Коттедж Gite le Moulin du Gouaix с кухней, собственным садом и принадлежностями для барбекю расположен в городе Жютини.
Staff at the hotel’s 24-hour reception can provide information about what Lastres and the surrounding area have to offer.	Сотрудники круглосуточной стойки регистрации отеля порекомендуют интересные достопримечательности и подскажут варианты проведения досуга в Ластресе и его окрестностях.
The Ernest N Morial Convention Center and Louisiana Superdome are a 5-minute drive from this upscale Sheraton hotel.	Конгресс-центр им. Эрнеста Мориала и стадион Мерседес-Бенц Супердоум находятся в 5 минутах езды от этого высококлассного бутик-отеля сети Sheraton.
Served in the conservatory-style dining room with panoramic views, continental or cooked breakfasts are available each morning.	Обеденный зал с панорамным видом оформлен в стиле зимнего сада. Каждое утро для гостей сервируют континентальный или английский завтрак.
Plenty of free parking is available.	На территории комплекса предусмотрено много парковочных мест.
Breakfast is buffet style at Palazzo del Capitano Relais & Wellness.	По утрам в отеле Palazzo del Capitano Relais & Wellness для гостей сервируется завтрак «шведский стол».